StateFIPS,CountyFIPS,Name,Total,Employed,Unemployed
01,001,"Autauga County, AL",25710,24395,1315
01,003,"Baldwin County, AL",89778,84972,4806
01,005,"Barbour County, AL",8334,7638,696
01,007,"Bibb County, AL",8539,7986,553
01,009,"Blount County, AL",24380,23061,1319
01,011,"Bullock County, AL",4785,4457,328
01,013,"Butler County, AL",9116,8484,632
01,015,"Calhoun County, AL",45450,42470,2980
01,017,"Chambers County, AL",14858,14044,814
01,019,"Cherokee County, AL",11241,10671,570
01,021,"Chilton County, AL",19029,17982,1047
01,023,"Choctaw County, AL",4292,3926,366
01,025,"Clarke County, AL",7889,7030,859
01,027,"Clay County, AL",5579,5247,332
01,029,"Cleburne County, AL",5738,5394,344
01,031,"Coffee County, AL",20429,19227,1202
01,033,"Colbert County, AL",23261,21640,1621
01,035,"Conecuh County, AL",4512,4131,381
01,037,"Coosa County, AL",4344,4084,260
01,039,"Covington County, AL",15366,14325,1041
01,041,"Crenshaw County, AL",6401,6024,377
01,043,"Cullman County, AL",37594,35720,1874
01,045,"Dale County, AL",19796,18648,1148
01,047,"Dallas County, AL",15293,13880,1413
01,049,"DeKalb County, AL",28996,27232,1764
01,051,"Elmore County, AL",36921,35161,1760
01,053,"Escambia County, AL",14433,13472,961
01,055,"Etowah County, AL",42914,40372,2542
01,057,"Fayette County, AL",6542,6100,442
01,059,"Franklin County, AL",13752,12941,811
01,061,"Geneva County, AL",10720,10097,623
01,063,"Greene County, AL",2848,2564,284
01,065,"Hale County, AL",5933,5478,455
01,067,"Henry County, AL",6666,6231,435
01,069,"Houston County, AL",44185,41621,2564
01,071,"Jackson County, AL",23390,21911,1479
01,073,"Jefferson County, AL",308632,290887,17745
01,075,"Lamar County, AL",5643,5324,319
01,077,"Lauderdale County, AL",42180,39490,2690
01,079,"Lawrence County, AL",13607,12665,942
01,081,"Lee County, AL",71759,67995,3764
01,083,"Limestone County, AL",40349,38229,2120
01,085,"Lowndes County, AL",3770,3371,399
01,087,"Macon County, AL",7803,7208,595
01,089,"Madison County, AL",172125,163288,8837
01,091,"Marengo County, AL",7608,7063,545
01,093,"Marion County, AL",12394,11572,822
01,095,"Marshall County, AL",41240,39034,2206
01,097,"Mobile County, AL",186230,173856,12374
01,099,"Monroe County, AL",7255,6596,659
01,101,"Montgomery County, AL",104883,98929,5954
01,103,"Morgan County, AL",54413,51395,3018
01,105,"Perry County, AL",3438,3083,355
01,107,"Pickens County, AL",7702,7172,530
01,109,"Pike County, AL",14825,13860,965
01,111,"Randolph County, AL",9350,8827,523
01,113,"Russell County, AL",23338,22038,1300
01,115,"St. Clair County, AL",38757,36745,2012
01,117,"Shelby County, AL",108670,103986,4684
01,119,"Sumter County, AL",5069,4678,391
01,121,"Talladega County, AL",34528,32244,2284
01,123,"Tallapoosa County, AL",18426,17396,1030
01,125,"Tuscaloosa County, AL",98431,92864,5567
01,127,"Walker County, AL",25356,23465,1891
01,129,"Washington County, AL",6686,6109,577
01,131,"Wilcox County, AL",2795,2391,404
01,133,"Winston County, AL",9455,8783,672
02,013,"Aleutians East Borough, AK",2589,2523,66
02,016,"Aleutians West Census Area, AK",3982,3856,126
02,020,"Anchorage Borough/municipality, AK",155471,147254,8217
02,050,"Bethel Census Area, AK",7219,6230,989
02,060,"Bristol Bay Borough, AK",413,385,28
02,068,"Denali Borough, AK",1091,996,95
02,070,"Dillingham Census Area, AK",2073,1881,192
02,090,"Fairbanks North Star Borough, AK",46443,43824,2619
02,100,"Haines Borough, AK",1071,966,105
02,105,"Hoonah-Angoon Census Area, AK",1200,1064,136
02,110,"Juneau Borough/city, AK",17343,16599,744
02,122,"Kenai Peninsula Borough, AK",27123,24906,2217
02,130,"Ketchikan Gateway Borough, AK",7019,6581,438
02,150,"Kodiak Island Borough, AK",6418,6101,317
02,158,"Kusilvak Census Area, AK",2706,2142,564
02,164,"Lake and Peninsula Borough, AK",653,575,78
02,170,"Matanuska-Susitna Borough, AK",47353,43613,3740
02,180,"Nome Census Area, AK",4072,3574,498
02,185,"North Slope Borough, AK",3951,3694,257
02,188,"Northwest Arctic Borough, AK",2950,2496,454
02,195,"Petersburg Borough, AK",1447,1322,125
02,198,"Prince of Wales-Hyder Census Area, AK",2760,2437,323
02,220,"Sitka Borough/city, AK",4373,4179,194
02,230,"Skagway Municipality, AK",803,717,86
02,240,"Southeast Fairbanks Census Area, AK",2990,2681,309
02,261,"Valdez-Cordova Census Area, AK",4802,4406,396
02,275,"Wrangell Borough/city, AK",1053,977,76
02,282,"Yakutat Borough/city, AK",244,224,20
02,290,"Yukon-Koyukuk Census Area, AK",2408,1994,414
04,001,"Apache County, AZ",20418,18042,2376
04,003,"Cochise County, AZ",49799,46647,3152
04,005,"Coconino County, AZ",74484,69930,4554
04,007,"Gila County, AZ",21084,19536,1548
04,009,"Graham County, AZ",14433,13445,988
04,011,"Greenlee County, AZ",3916,3615,301
04,012,"La Paz County, AZ",8506,7983,523
04,013,"Maricopa County, AZ",2088551,1991371,97180
04,015,"Mohave County, AZ",80843,75410,5433
04,017,"Navajo County, AZ",41511,38030,3481
04,019,"Pima County, AZ",471452,447695,23757
04,021,"Pinal County, AZ",164605,155330,9275
04,023,"Santa Cruz County, AZ",19282,17317,1965
04,025,"Yavapai County, AZ",99916,94913,5003
04,027,"Yuma County, AZ",94671,76590,18081
05,001,"Arkansas County, AR",9284,8967,317
05,003,"Ashley County, AR",7966,7477,489
05,005,"Baxter County, AR",16130,15435,695
05,007,"Benton County, AR",128130,124390,3740
05,009,"Boone County, AR",15957,15370,587
05,011,"Bradley County, AR",4491,4265,226
05,013,"Calhoun County, AR",2396,2286,110
05,015,"Carroll County, AR",12891,12432,459
05,017,"Chicot County, AR",3590,3353,237
05,019,"Clark County, AR",9589,9173,416
05,021,"Clay County, AR",6048,5706,342
05,023,"Cleburne County, AR",9500,8935,565
05,025,"Cleveland County, AR",3349,3198,151
05,027,"Columbia County, AR",9313,8781,532
05,029,"Conway County, AR",8468,7983,485
05,031,"Craighead County, AR",52315,50613,1702
05,033,"Crawford County, AR",26995,25941,1054
05,035,"Crittenden County, AR",21642,20664,978
05,037,"Cross County, AR",7897,7547,350
05,039,"Dallas County, AR",2987,2842,145
05,041,"Desha County, AR",5455,5157,298
05,043,"Drew County, AR",8002,7549,453
05,045,"Faulkner County, AR",60654,58345,2309
05,047,"Franklin County, AR",7378,7079,299
05,049,"Fulton County, AR",4675,4472,203
05,051,"Garland County, AR",40152,38421,1731
05,053,"Grant County, AR",8288,7989,299
05,055,"Greene County, AR",19839,18987,852
05,057,"Hempstead County, AR",10019,9643,376
05,059,"Hot Spring County, AR",14139,13582,557
05,061,"Howard County, AR",5989,5793,196
05,063,"Independence County, AR",16039,15243,796
05,065,"Izard County, AR",4976,4696,280
05,067,"Jackson County, AR",6068,5689,379
05,069,"Jefferson County, AR",28373,26779,1594
05,071,"Johnson County, AR",10551,10049,502
05,073,"Lafayette County, AR",2586,2435,151
05,075,"Lawrence County, AR",6929,6628,301
05,077,"Lee County, AR",3098,2951,147
05,079,"Lincoln County, AR",4102,3904,198
05,081,"Little River County, AR",5602,5339,263
05,083,"Logan County, AR",9145,8724,421
05,085,"Lonoke County, AR",33442,32327,1115
05,087,"Madison County, AR",7297,7063,234
05,089,"Marion County, AR",6532,6271,261
05,091,"Miller County, AR",19904,19067,837
05,093,"Mississippi County, AR",18099,16869,1230
05,095,"Monroe County, AR",2886,2747,139
05,097,"Montgomery County, AR",3133,2972,161
05,099,"Nevada County, AR",3650,3515,135
05,101,"Newton County, AR",3417,3284,133
05,103,"Ouachita County, AR",9897,9399,498
05,105,"Perry County, AR",4174,3974,200
05,107,"Phillips County, AR",6668,6274,394
05,109,"Pike County, AR",4228,4048,180
05,111,"Poinsett County, AR",10108,9675,433
05,113,"Polk County, AR",8194,7794,400
05,115,"Pope County, AR",29332,27981,1351
05,117,"Prairie County, AR",3656,3516,140
05,119,"Pulaski County, AR",187419,180752,6667
05,121,"Randolph County, AR",6534,6232,302
05,123,"St. Francis County, AR",8855,8394,461
05,125,"Saline County, AR",56952,55170,1782
05,127,"Scott County, AR",4469,4305,164
05,129,"Searcy County, AR",2994,2857,137
05,131,"Sebastian County, AR",57697,55543,2154
05,133,"Sevier County, AR",5704,5427,277
05,135,"Sharp County, AR",6062,5731,331
05,137,"Stone County, AR",4748,4504,244
05,139,"Union County, AR",16401,15504,897
05,141,"Van Buren County, AR",6113,5692,421
05,143,"Washington County, AR",118574,115300,3274
05,145,"White County, AR",34092,32318,1774
05,147,"Woodruff County, AR",2974,2811,163
05,149,"Yell County, AR",8700,8311,389
06,001,"Alameda County, CA",831827,796037,35790
06,003,"Alpine County, CA",554,518,36
06,005,"Amador County, CA",14525,13658,867
06,007,"Butte County, CA",101648,94909,6739
06,009,"Calaveras County, CA",20798,19615,1183
06,011,"Colusa County, CA",10908,9205,1703
06,013,"Contra Costa County, CA",553221,528401,24820
06,015,"Del Norte County, CA",9755,9019,736
06,017,"El Dorado County, CA",88824,84248,4576
06,019,"Fresno County, CA",444737,402364,42373
06,021,"Glenn County, CA",12949,11867,1082
06,023,"Humboldt County, CA",62424,59338,3086
06,025,"Imperial County, CA",75186,56998,18188
06,027,"Inyo County, CA",8860,8390,470
06,029,"Kern County, CA",388109,347692,40417
06,031,"Kings County, CA",57161,51446,5715
06,033,"Lake County, CA",29067,27108,1959
06,035,"Lassen County, CA",10363,9642,721
06,037,"Los Angeles County, CA",5018920,4751209,267711
06,039,"Madera County, CA",61051,55393,5658
06,041,"Marin County, CA",139632,135040,4592
06,043,"Mariposa County, CA",7568,7048,520
06,045,"Mendocino County, CA",39617,37521,2096
06,047,"Merced County, CA",114339,102211,12128
06,049,"Modoc County, CA",3292,3034,258
06,051,"Mono County, CA",8365,7915,450
06,053,"Monterey County, CA",218802,201971,16831
06,055,"Napa County, CA",72941,69799,3142
06,057,"Nevada County, CA",48147,45838,2309
06,059,"Orange County, CA",1597447,1532725,64722
06,061,"Placer County, CA",179634,171550,8084
06,063,"Plumas County, CA",7851,7085,766
06,065,"Riverside County, CA",1051610,987187,64423
06,067,"Sacramento County, CA",693979,656360,37619
06,069,"San Benito County, CA",30434,28398,2036
06,071,"San Bernardino County, CA",930242,876387,53855
06,073,"San Diego County, CA",1563246,1489143,74103
06,075,"San Francisco County/city, CA",555316,536972,18344
06,077,"San Joaquin County, CA",318316,292367,25949
06,079,"San Luis Obispo County, CA",139484,133438,6046
06,081,"San Mateo County, CA",441792,428282,13510
06,083,"Santa Barbara County, CA",215256,204329,10927
06,085,"Santa Clara County, CA",1027918,989048,38870
06,087,"Santa Cruz County, CA",143764,133730,10034
06,089,"Shasta County, CA",74207,69019,5188
06,091,"Sierra County, CA",1334,1232,102
06,093,"Siskiyou County, CA",17896,16370,1526
06,095,"Solano County, CA",207273,195835,11438
06,097,"Sonoma County, CA",259214,248876,10338
06,099,"Stanislaus County, CA",242737,221769,20968
06,101,"Sutter County, CA",44983,40612,4371
06,103,"Tehama County, CA",25071,23280,1791
06,105,"Trinity County, CA",4993,4638,355
06,107,"Tulare County, CA",203292,180503,22789
06,109,"Tuolumne County, CA",21567,20221,1346
06,111,"Ventura County, CA",425346,403087,22259
06,113,"Yolo County, CA",106078,99812,6266
06,115,"Yuba County, CA",28153,25722,2431
08,001,"Adams County, CO",253599,244903,8696
08,003,"Alamosa County, CO",7964,7657,307
08,005,"Arapahoe County, CO",340623,330532,10091
08,007,"Archuleta County, CO",6365,6165,200
08,009,"Baca County, CO",2093,2059,34
08,011,"Bent County, CO",1851,1797,54
08,013,"Boulder County, CO",180901,176286,4615
08,014,"Broomfield County/city, CO",36784,35767,1017
08,015,"Chaffee County, CO",8843,8619,224
08,017,"Cheyenne County, CO",1081,1058,23
08,019,"Clear Creek County, CO",5686,5513,173
08,021,"Conejos County, CO",3769,3594,175
08,023,"Costilla County, CO",1728,1648,80
08,025,"Crowley County, CO",1422,1374,48
08,027,"Custer County, CO",2019,1958,61
08,029,"Delta County, CO",13948,13293,655
08,031,"Denver County/city, CO",385108,373645,11463
08,033,"Dolores County, CO",1071,1031,40
08,035,"Douglas County, CO",177570,173042,4528
08,037,"Eagle County, CO",33733,32848,885
08,039,"Elbert County, CO",13802,13460,342
08,041,"El Paso County, CO",314650,303352,11298
08,043,"Fremont County, CO",14695,13968,727
08,045,"Garfield County, CO",30994,29959,1035
08,047,"Gilpin County, CO",3485,3406,79
08,049,"Grand County, CO",9191,8955,236
08,051,"Gunnison County, CO",10140,9918,222
08,053,"Hinsdale County, CO",447,437,10
08,055,"Huerfano County, CO",2497,2346,151
08,057,"Jackson County, CO",892,869,23
08,059,"Jefferson County, CO",315406,306493,8913
08,061,"Kiowa County, CO",846,830,16
08,063,"Kit Carson County, CO",4540,4448,92
08,065,"Lake County, CO",4618,4492,126
08,067,"La Plata County, CO",30992,30141,851
08,069,"Larimer County, CO",187400,182374,5026
08,071,"Las Animas County, CO",6183,5884,299
08,073,"Lincoln County, CO",2280,2224,56
08,075,"Logan County, CO",11017,10707,310
08,077,"Mesa County, CO",72044,68374,3670
08,079,"Mineral County, CO",464,454,10
08,081,"Moffat County, CO",7180,6908,272
08,083,"Montezuma County, CO",12715,12112,603
08,085,"Montrose County, CO",20062,19268,794
08,087,"Morgan County, CO",15039,14542,497
08,089,"Otero County, CO",8110,7745,365
08,091,"Ouray County, CO",2166,2088,78
08,093,"Park County, CO",9836,9574,262
08,095,"Phillips County, CO",2472,2426,46
08,097,"Pitkin County, CO",10736,10390,346
08,099,"Prowers County, CO",6006,5820,186
08,101,"Pueblo County, CO",73058,69714,3344
08,103,"Rio Blanco County, CO",2735,2603,132
08,105,"Rio Grande County, CO",5153,4909,244
08,107,"Routt County, CO",14912,14539,373
08,109,"Saguache County, CO",3226,3075,151
08,111,"San Juan County, CO",479,462,17
08,113,"San Miguel County, CO",5185,5024,161
08,115,"Sedgwick County, CO",1178,1152,26
08,117,"Summit County, CO",21140,20722,418
08,119,"Teller County, CO",11731,11315,416
08,121,"Washington County, CO",2921,2861,60
08,123,"Weld County, CO",149941,145047,4894
08,125,"Yuma County, CO",5441,5330,111
09,001,"Fairfield County, CT",480229,458116,22113
09,003,"Hartford County, CT",474494,450542,23952
09,005,"Litchfield County, CT",104750,100083,4667
09,007,"Middlesex County, CT",92489,88623,3866
09,009,"New Haven County, CT",457003,433288,23715
09,011,"New London County, CT",136181,129595,6586
09,013,"Tolland County, CT",85416,81803,3613
09,015,"Windham County, CT",62639,59342,3297
10,001,"Kent County, DE",76699,72935,3764
10,003,"New Castle County, DE",291757,278853,12904
10,005,"Sussex County, DE",100352,95852,4500
11,001,District of Columbia,395124,370553,24571
12,001,"Alachua County, FL",133055,127302,5753
12,003,"Baker County, FL",11456,10892,564
12,005,"Bay County, FL",88209,83963,4246
12,007,"Bradford County, FL",10896,10427,469
12,009,"Brevard County, FL",263418,249817,13601
12,011,"Broward County, FL",1007259,961500,45759
12,013,"Calhoun County, FL",5003,4713,290
12,015,"Charlotte County, FL",69519,65781,3738
12,017,"Citrus County, FL",48006,44748,3258
12,019,"Clay County, FL",101345,96747,4598
12,021,"Collier County, FL",169758,161752,8006
12,023,"Columbia County, FL",29856,28387,1469
12,027,"DeSoto County, FL",13516,12797,719
12,029,"Dixie County, FL",5669,5358,311
12,031,"Duval County, FL",469165,445908,23257
12,033,"Escambia County, FL",141419,134347,7072
12,035,"Flagler County, FL",45492,42967,2525
12,037,"Franklin County, FL",4752,4544,208
12,039,"Gadsden County, FL",18269,17114,1155
12,041,"Gilchrist County, FL",6698,6360,338
12,043,"Glades County, FL",4734,4436,298
12,045,"Gulf County, FL",5985,5704,281
12,047,"Hamilton County, FL",4673,4406,267
12,049,"Hardee County, FL",9287,8664,623
12,051,"Hendry County, FL",15462,14133,1329
12,053,"Hernando County, FL",68152,63991,4161
12,055,"Highlands County, FL",35846,33481,2365
12,057,"Hillsborough County, FL",709538,677812,31726
12,059,"Holmes County, FL",6734,6367,367
12,061,"Indian River County, FL",62394,58604,3790
12,063,"Jackson County, FL",17396,16480,916
12,065,"Jefferson County, FL",5404,5117,287
12,067,"Lafayette County, FL",2977,2846,131
12,069,"Lake County, FL",146577,139389,7188
12,071,"Lee County, FL",330398,314990,15408
12,073,"Leon County, FL",150702,143808,6894
12,075,"Levy County, FL",16702,15831,871
12,077,"Liberty County, FL",2646,2509,137
12,079,"Madison County, FL",7350,6960,390
12,081,"Manatee County, FL",171148,163281,7867
12,083,"Marion County, FL",132466,124689,7777
12,085,"Martin County, FL",71125,67646,3479
12,086,"Miami-Dade County, FL",1305259,1233029,72230
12,087,"Monroe County, FL",46592,45095,1497
12,089,"Nassau County, FL",37897,36176,1721
12,091,"Okaloosa County, FL",93533,89740,3793
12,093,"Okeechobee County, FL",18205,17261,944
12,095,"Orange County, FL",708817,677671,31146
12,097,"Osceola County, FL",164792,156541,8251
12,099,"Palm Beach County, FL",711609,677839,33770
12,101,"Pasco County, FL",223250,211693,11557
12,103,"Pinellas County, FL",479772,458724,21048
12,105,"Polk County, FL",287843,271786,16057
12,107,"Putnam County, FL",27071,25332,1739
12,109,"St. Johns County, FL",118966,114422,4544
12,111,"St. Lucie County, FL",135657,127736,7921
12,113,"Santa Rosa County, FL",76371,72892,3479
12,115,"Sarasota County, FL",181607,173272,8335
12,117,"Seminole County, FL",242812,232335,10477
12,119,"Sumter County, FL",29490,27358,2132
12,121,"Suwannee County, FL",18243,17342,901
12,123,"Taylor County, FL",8866,8383,483
12,125,"Union County, FL",4811,4601,210
12,127,"Volusia County, FL",246286,233701,12585
12,129,"Wakulla County, FL",14342,13743,599
12,131,"Walton County, FL",29035,27776,1259
12,133,"Washington County, FL",9732,9228,504
13,001,"Appling County, GA",9191,8596,595
13,003,"Atkinson County, GA",3976,3765,211
13,005,"Bacon County, GA",4981,4717,264
13,007,"Baker County, GA",1181,1089,92
13,009,"Baldwin County, GA",17637,16414,1223
13,011,"Banks County, GA",8816,8382,434
13,013,"Barrow County, GA",37699,35894,1805
13,015,"Bartow County, GA",48194,45690,2504
13,017,"Ben Hill County, GA",5550,5089,461
13,019,"Berrien County, GA",7220,6772,448
13,021,"Bibb County, GA",68659,64517,4142
13,023,"Bleckley County, GA",4504,4143,361
13,025,"Brantley County, GA",7098,6614,484
13,027,"Brooks County, GA",7010,6638,372
13,029,"Bryan County, GA",16928,16093,835
13,031,"Bulloch County, GA",35965,33878,2087
13,033,"Burke County, GA",9244,8522,722
13,035,"Butts County, GA",10379,9786,593
13,037,"Calhoun County, GA",2164,2040,124
13,039,"Camden County, GA",20352,19164,1188
13,043,"Candler County, GA",5071,4825,246
13,045,"Carroll County, GA",53550,50291,3259
13,047,"Catoosa County, GA",32172,30595,1577
13,049,"Charlton County, GA",4741,4470,271
13,051,"Chatham County, GA",136088,128852,7236
13,053,"Chattahoochee County, GA",2060,1887,173
13,055,"Chattooga County, GA",10436,9769,667
13,057,"Cherokee County, GA",125883,120452,5431
13,059,"Clarke County, GA",58767,55484,3283
13,061,"Clay County, GA",884,791,93
13,063,"Clayton County, GA",130800,122049,8751
13,065,"Clinch County, GA",2769,2596,173
13,067,"Cobb County, GA",410083,390988,19095
13,069,"Coffee County, GA",18092,17024,1068
13,071,"Colquitt County, GA",21103,19979,1124
13,073,"Columbia County, GA",71036,67691,3345
13,075,"Cook County, GA",7524,7111,413
13,077,"Coweta County, GA",70403,66854,3549
13,079,"Crawford County, GA",5678,5339,339
13,081,"Crisp County, GA",9191,8629,562
13,083,"Dade County, GA",8018,7607,411
13,085,"Dawson County, GA",11330,10793,537
13,087,"Decatur County, GA",11476,10703,773
13,089,"DeKalb County, GA",382731,361823,20908
13,091,"Dodge County, GA",7018,6501,517
13,093,"Dooly County, GA",4951,4660,291
13,095,"Dougherty County, GA",38172,35525,2647
13,097,"Douglas County, GA",70232,66273,3959
13,099,"Early County, GA",4401,4095,306
13,101,"Echols County, GA",1882,1800,82
13,103,"Effingham County, GA",28415,27025,1390
13,105,"Elbert County, GA",7730,7223,507
13,107,"Emanuel County, GA",8448,7786,662
13,109,"Evans County, GA",4788,4550,238
13,111,"Fannin County, GA",10829,10242,587
13,113,"Fayette County, GA",55712,53051,2661
13,115,"Floyd County, GA",43503,40856,2647
13,117,"Forsyth County, GA",110988,106296,4692
13,119,"Franklin County, GA",9788,9269,519
13,121,"Fulton County, GA",531124,502170,28954
13,123,"Gilmer County, GA",11833,11152,681
13,125,"Glascock County, GA",1268,1191,77
13,127,"Glynn County, GA",39177,37071,2106
13,129,"Gordon County, GA",25300,23865,1435
13,131,"Grady County, GA",10250,9685,565
13,133,"Greene County, GA",6605,6200,405
13,135,"Gwinnett County, GA",467734,445147,22587
13,137,"Habersham County, GA",19302,18268,1034
13,139,"Hall County, GA",96308,91917,4391
13,141,"Hancock County, GA",2532,2317,215
13,143,"Haralson County, GA",12159,11445,714
13,145,"Harris County, GA",16066,15271,795
13,147,"Hart County, GA",11013,10414,599
13,149,"Heard County, GA",4996,4697,299
13,151,"Henry County, GA",108917,102845,6072
13,153,"Houston County, GA",67671,64005,3666
13,155,"Irwin County, GA",3219,2964,255
13,157,"Jackson County, GA",33289,31852,1437
13,159,"Jasper County, GA",6581,6262,319
13,161,"Jeff Davis County, GA",6226,5825,401
13,163,"Jefferson County, GA",6599,6106,493
13,165,"Jenkins County, GA",3163,2921,242
13,167,"Johnson County, GA",3925,3683,242
13,169,"Jones County, GA",13792,13121,671
13,171,"Lamar County, GA",7900,7375,525
13,173,"Lanier County, GA",3828,3604,224
13,175,"Laurens County, GA",19066,17781,1285
13,177,"Lee County, GA",14557,13865,692
13,179,"Liberty County, GA",25047,23562,1485
13,181,"Lincoln County, GA",3479,3271,208
13,183,"Long County, GA",7424,7018,406
13,185,"Lowndes County, GA",51312,48569,2743
13,187,"Lumpkin County, GA",15975,15199,776
13,189,"McDuffie County, GA",8802,8150,652
13,191,"McIntosh County, GA",6004,5649,355
13,193,"Macon County, GA",4681,4289,392
13,195,"Madison County, GA",13084,12428,656
13,197,"Marion County, GA",3381,3130,251
13,199,"Meriwether County, GA",8759,8150,609
13,201,"Miller County, GA",2753,2602,151
13,205,"Mitchell County, GA",8569,7999,570
13,207,"Monroe County, GA",13018,12336,682
13,209,"Montgomery County, GA",3725,3444,281
13,211,"Morgan County, GA",8698,8254,444
13,213,"Murray County, GA",15645,14521,1124
13,215,"Muscogee County, GA",78438,73041,5397
13,217,"Newton County, GA",50006,46972,3034
13,219,"Oconee County, GA",18472,17706,766
13,221,"Oglethorpe County, GA",6919,6578,341
13,223,"Paulding County, GA",79648,75914,3734
13,225,"Peach County, GA",11441,10630,811
13,227,"Pickens County, GA",14404,13692,712
13,229,"Pierce County, GA",8556,8097,459
13,231,"Pike County, GA",8402,7961,441
13,233,"Polk County, GA",18072,16948,1124
13,235,"Pulaski County, GA",4039,3799,240
13,237,"Putnam County, GA",7955,7388,567
13,239,"Quitman County, GA",815,755,60
13,241,"Rabun County, GA",6700,6299,401
13,243,"Randolph County, GA",2475,2263,212
13,245,"Richmond County, GA",84842,79035,5807
13,247,"Rockdale County, GA",43254,40714,2540
13,249,"Schley County, GA",2117,1982,135
13,251,"Screven County, GA",5240,4840,400
13,253,"Seminole County, GA",3093,2846,247
13,255,"Spalding County, GA",27798,25863,1935
13,257,"Stephens County, GA",11033,10376,657
13,259,"Stewart County, GA",2138,2000,138
13,261,"Sumter County, GA",12849,11864,985
13,263,"Talbot County, GA",2745,2559,186
13,265,"Taliaferro County, GA",548,510,38
13,267,"Tattnall County, GA",9330,8825,505
13,269,"Taylor County, GA",3323,3071,252
13,271,"Telfair County, GA",4811,4403,408
13,273,"Terrell County, GA",3657,3417,240
13,275,"Thomas County, GA",17533,16425,1108
13,277,"Tift County, GA",18553,17541,1012
13,279,"Toombs County, GA",11789,10856,933
13,281,"Towns County, GA",4108,3825,283
13,283,"Treutlen County, GA",2743,2529,214
13,285,"Troup County, GA",36835,34934,1901
13,287,"Turner County, GA",3236,3024,212
13,289,"Twiggs County, GA",2950,2690,260
13,291,"Union County, GA",10451,9949,502
13,293,"Upson County, GA",11143,10415,728
13,295,"Walker County, GA",29938,28247,1691
13,297,"Walton County, GA",43382,41222,2160
13,299,"Ware County, GA",15484,14637,847
13,301,"Warren County, GA",2700,2510,190
13,303,"Washington County, GA",7184,6723,461
13,305,"Wayne County, GA",11296,10512,784
13,307,"Webster County, GA",967,883,84
13,309,"Wheeler County, GA",1734,1576,158
13,311,"White County, GA",14481,13801,680
13,313,"Whitfield County, GA",44742,41968,2774
13,315,"Wilcox County, GA",2720,2521,199
13,317,"Wilkes County, GA",3708,3459,249
13,319,"Wilkinson County, GA",3650,3416,234
13,321,"Worth County, GA",9125,8586,539
15,001,"Hawaii County, HI",92474,89228,3246
15,003,"Honolulu County/city, HI",463370,450745,12625
15,007,"Kauai County, HI",36587,35468,1119
15,009,"Maui County, HI",86690,84117,2573
16,001,"Ada County, ID",225135,217925,7210
16,003,"Adams County, ID",1740,1624,116
16,005,"Bannock County, ID",41066,39648,1418
16,007,"Bear Lake County, ID",2808,2684,124
16,009,"Benewah County, ID",4007,3778,229
16,011,"Bingham County, ID",22783,22007,776
16,013,"Blaine County, ID",11843,11482,361
16,015,"Boise County, ID",3092,2935,157
16,017,"Bonner County, ID",18871,17879,992
16,019,"Bonneville County, ID",52377,50762,1615
16,021,"Boundary County, ID",5098,4841,257
16,023,"Butte County, ID",1293,1241,52
16,025,"Camas County, ID",658,635,23
16,027,"Canyon County, ID",93555,89622,3933
16,029,"Caribou County, ID",3792,3661,131
16,031,"Cassia County, ID",11589,11254,335
16,033,"Clark County, ID",393,381,12
16,035,"Clearwater County, ID",3045,2830,215
16,037,"Custer County, ID",2138,2033,105
16,039,"Elmore County, ID",10948,10511,437
16,041,"Franklin County, ID",6639,6442,197
16,043,"Fremont County, ID",7367,7127,240
16,045,"Gem County, ID",7723,7373,350
16,047,"Gooding County, ID",7997,7759,238
16,049,"Idaho County, ID",6334,5986,348
16,051,"Jefferson County, ID",12823,12439,384
16,053,"Jerome County, ID",11344,10998,346
16,055,"Kootenai County, ID",73762,70446,3316
16,057,"Latah County, ID",19892,19281,611
16,059,"Lemhi County, ID",3403,3202,201
16,061,"Lewis County, ID",1624,1524,100
16,063,"Lincoln County, ID",2639,2525,114
16,065,"Madison County, ID",20565,20083,482
16,067,"Minidoka County, ID",10871,10535,336
16,069,"Nez Perce County, ID",20861,20198,663
16,071,"Oneida County, ID",2200,2123,77
16,073,"Owyhee County, ID",5276,5042,234
16,075,"Payette County, ID",11247,10742,505
16,077,"Power County, ID",3927,3772,155
16,079,"Shoshone County, ID",5108,4757,351
16,081,"Teton County, ID",5980,5793,187
16,083,"Twin Falls County, ID",39555,38249,1306
16,085,"Valley County, ID",4959,4701,258
16,087,"Washington County, ID",4595,4350,245
17,001,"Adams County, IL",32621,31068,1553
17,003,"Alexander County, IL",2215,2008,207
17,005,"Bond County, IL",7911,7506,405
17,007,"Boone County, IL",26437,24753,1684
17,009,"Brown County, IL",2868,2771,97
17,011,"Bureau County, IL",17450,16393,1057
17,013,"Calhoun County, IL",2383,2237,146
17,015,"Carroll County, IL",7900,7452,448
17,017,"Cass County, IL",6239,5890,349
17,019,"Champaign County, IL",107858,102462,5396
17,021,"Christian County, IL",15355,14373,982
17,023,"Clark County, IL",8197,7720,477
17,025,"Clay County, IL",6734,6274,460
17,027,"Clinton County, IL",20537,19621,916
17,029,"Coles County, IL",24628,23173,1455
17,031,"Cook County, IL",2664757,2500070,164687
17,033,"Crawford County, IL",9065,8498,567
17,035,"Cumberland County, IL",6009,5694,315
17,037,"DeKalb County, IL",55418,52454,2964
17,039,"De Witt County, IL",7975,7521,454
17,041,"Douglas County, IL",10326,9839,487
17,043,"DuPage County, IL",516779,491849,24930
17,045,"Edgar County, IL",9747,9163,584
17,047,"Edwards County, IL",2984,2811,173
17,049,"Effingham County, IL",18775,17880,895
17,051,"Fayette County, IL",9786,9149,637
17,053,"Ford County, IL",6683,6319,364
17,055,"Franklin County, IL",16765,15406,1359
17,057,"Fulton County, IL",15871,14697,1174
17,059,"Gallatin County, IL",2546,2352,194
17,061,"Greene County, IL",6095,5740,355
17,063,"Grundy County, IL",25767,23999,1768
17,065,"Hamilton County, IL",4273,4007,266
17,067,"Hancock County, IL",8868,8289,579
17,069,"Hardin County, IL",1400,1269,131
17,071,"Henderson County, IL",3732,3505,227
17,073,"Henry County, IL",25322,23793,1529
17,075,"Iroquois County, IL",14860,14040,820
17,077,"Jackson County, IL",28802,27249,1553
17,079,"Jasper County, IL",4665,4373,292
17,081,"Jefferson County, IL",17642,16512,1130
17,083,"Jersey County, IL",11102,10455,647
17,085,"Jo Daviess County, IL",11425,10810,615
17,087,"Johnson County, IL",4227,3858,369
17,089,"Kane County, IL",271322,256305,15017
17,091,"Kankakee County, IL",54935,51381,3554
17,093,"Kendall County, IL",67962,64414,3548
17,095,"Knox County, IL",23035,21619,1416
17,097,"Lake County, IL",373373,353803,19570
17,099,"LaSalle County, IL",57348,53477,3871
17,101,"Lawrence County, IL",6200,5741,459
17,103,"Lee County, IL",18097,17168,929
17,105,"Livingston County, IL",17097,16174,923
17,107,"Logan County, IL",13097,12398,699
17,109,"McDonough County, IL",14086,13203,883
17,111,"McHenry County, IL",167872,158890,8982
17,113,"McLean County, IL",90908,86313,4595
17,115,"Macon County, IL",50782,47430,3352
17,117,"Macoupin County, IL",23458,22060,1398
17,119,"Madison County, IL",135685,127691,7994
17,121,"Marion County, IL",18104,16947,1157
17,123,"Marshall County, IL",5656,5280,376
17,125,"Mason County, IL",6466,6005,461
17,127,"Massac County, IL",6018,5588,430
17,129,"Menard County, IL",6772,6454,318
17,131,"Mercer County, IL",8258,7744,514
17,133,"Monroe County, IL",18565,17810,755
17,135,"Montgomery County, IL",12160,11297,863
17,137,"Morgan County, IL",17005,16165,840
17,139,"Moultrie County, IL",7475,7133,342
17,141,"Ogle County, IL",25900,24368,1532
17,143,"Peoria County, IL",88412,82310,6102
17,145,"Perry County, IL",8743,8121,622
17,147,"Piatt County, IL",8729,8305,424
17,149,"Pike County, IL",7542,7155,387
17,151,"Pope County, IL",1774,1647,127
17,153,"Pulaski County, IL",2203,2017,186
17,155,"Putnam County, IL",3121,2945,176
17,157,"Randolph County, IL",14609,13878,731
17,159,"Richland County, IL",7574,7124,450
17,161,"Rock Island County, IL",72387,67847,4540
17,163,"St. Clair County, IL",127728,119971,7757
17,165,"Saline County, IL",10092,9228,864
17,167,"Sangamon County, IL",104237,99031,5206
17,169,"Schuyler County, IL",3372,3183,189
17,171,"Scott County, IL",2538,2394,144
17,173,"Shelby County, IL",10439,9842,597
17,175,"Stark County, IL",2771,2567,204
17,177,"Stephenson County, IL",21497,20237,1260
17,179,"Tazewell County, IL",66050,61804,4246
17,181,"Union County, IL",7555,6995,560
17,183,"Vermilion County, IL",35043,32499,2544
17,185,"Wabash County, IL",5778,5415,363
17,187,"Warren County, IL",8734,8273,461
17,189,"Washington County, IL",9686,9321,365
17,191,"Wayne County, IL",7332,6707,625
17,193,"White County, IL",6919,6464,455
17,195,"Whiteside County, IL",28851,27177,1674
17,197,"Will County, IL",362899,340783,22116
17,199,"Williamson County, IL",32460,30465,1995
17,201,"Winnebago County, IL",141910,132448,9462
17,203,"Woodford County, IL",19433,18367,1066
18,001,"Adams County, IN",17057,16454,603
18,003,"Allen County, IN",181043,173422,7621
18,005,"Bartholomew County, IN",44497,43010,1487
18,007,"Benton County, IN",4570,4379,191
18,009,"Blackford County, IN",5341,5059,282
18,011,"Boone County, IN",34896,33733,1163
18,013,"Brown County, IN",7531,7232,299
18,015,"Carroll County, IN",10118,9695,423
18,017,"Cass County, IN",18065,17238,827
18,019,"Clark County, IN",60593,58105,2488
18,021,"Clay County, IN",12399,11826,573
18,023,"Clinton County, IN",17170,16512,658
18,025,"Crawford County, IN",5003,4725,278
18,027,"Daviess County, IN",15990,15432,558
18,029,"Dearborn County, IN",25622,24431,1191
18,031,"Decatur County, IN",14571,14059,512
18,033,"DeKalb County, IN",22257,21397,860
18,035,"Delaware County, IN",55129,52342,2787
18,037,"Dubois County, IN",23421,22702,719
18,039,"Elkhart County, IN",108584,104854,3730
18,041,"Fayette County, IN",9358,8827,531
18,043,"Floyd County, IN",41025,39369,1656
18,045,"Fountain County, IN",7977,7520,457
18,047,"Franklin County, IN",11490,10998,492
18,049,"Fulton County, IN",9896,9439,457
18,051,"Gibson County, IN",19219,18532,687
18,053,"Grant County, IN",32170,30606,1564
18,055,"Greene County, IN",13751,12864,887
18,057,"Hamilton County, IN",174686,169167,5519
18,059,"Hancock County, IN",38727,37281,1446
18,061,"Harrison County, IN",19976,19148,828
18,063,"Hendricks County, IN",85878,82920,2958
18,065,"Henry County, IN",22136,21128,1008
18,067,"Howard County, IN",38114,36365,1749
18,069,"Huntington County, IN",18707,17958,749
18,071,"Jackson County, IN",22370,21563,807
18,073,"Jasper County, IN",16585,15714,871
18,075,"Jay County, IN",9955,9510,445
18,077,"Jefferson County, IN",15300,14597,703
18,079,"Jennings County, IN",13278,12656,622
18,081,"Johnson County, IN",80340,77460,2880
18,083,"Knox County, IN",19084,18261,823
18,085,"Kosciusko County, IN",41542,40008,1534
18,087,"LaGrange County, IN",19445,18784,661
18,089,"Lake County, IN",232420,217907,14513
18,091,"LaPorte County, IN",48689,45863,2826
18,093,"Lawrence County, IN",20611,19455,1156
18,095,"Madison County, IN",59021,56085,2936
18,097,"Marion County, IN",481919,460661,21258
18,099,"Marshall County, IN",24351,23451,900
18,101,"Martin County, IN",5155,4947,208
18,103,"Miami County, IN",16103,15351,752
18,105,"Monroe County, IN",68053,64931,3122
18,107,"Montgomery County, IN",19178,18450,728
18,109,"Morgan County, IN",36074,34561,1513
18,111,"Newton County, IN",7043,6655,388
18,113,"Noble County, IN",23354,22419,935
18,115,"Ohio County, IN",3227,3072,155
18,117,"Orange County, IN",8888,8443,445
18,119,"Owen County, IN",9268,8759,509
18,121,"Parke County, IN",7273,6899,374
18,123,"Perry County, IN",9470,9044,426
18,125,"Pike County, IN",6337,6065,272
18,127,"Porter County, IN",86357,81990,4367
18,129,"Posey County, IN",13465,12941,524
18,131,"Pulaski County, IN",6386,6104,282
18,133,"Putnam County, IN",16619,15880,739
18,135,"Randolph County, IN",12681,12118,563
18,137,"Ripley County, IN",14078,13442,636
18,139,"Rush County, IN",8987,8654,333
18,141,"St. Joseph County, IN",134247,128253,5994
18,143,"Scott County, IN",10486,9984,502
18,145,"Shelby County, IN",22980,22074,906
18,147,"Spencer County, IN",10988,10543,445
18,149,"Starke County, IN",10869,10289,580
18,151,"Steuben County, IN",20104,19379,725
18,153,"Sullivan County, IN",8707,8202,505
18,155,"Switzerland County, IN",5000,4759,241
18,157,"Tippecanoe County, IN",94482,90699,3783
18,159,"Tipton County, IN",8537,8213,324
18,161,"Union County, IN",3641,3496,145
18,163,"Vanderburgh County, IN",93328,89539,3789
18,165,"Vermillion County, IN",7276,6803,473
18,167,"Vigo County, IN",49419,46792,2627
18,169,"Wabash County, IN",15493,14842,651
18,171,"Warren County, IN",4116,3919,197
18,173,"Warrick County, IN",32516,31221,1295
18,175,"Washington County, IN",13696,13078,618
18,177,"Wayne County, IN",30980,29514,1466
18,179,"Wells County, IN",14183,13685,498
18,181,"White County, IN",13658,13122,536
18,183,"Whitley County, IN",17252,16591,661
19,001,"Adair County, IA",4255,4131,124
19,003,"Adams County, IA",2227,2169,58
19,005,"Allamakee County, IA",7708,7329,379
19,007,"Appanoose County, IA",6190,5900,290
19,009,"Audubon County, IA",3293,3185,108
19,011,"Benton County, IA",13666,13179,487
19,013,"Black Hawk County, IA",69624,66425,3199
19,015,"Boone County, IA",15193,14772,421
19,017,"Bremer County, IA",13979,13483,496
19,019,"Buchanan County, IA",11259,10799,460
19,021,"Buena Vista County, IA",11571,11167,404
19,023,"Butler County, IA",8070,7722,348
19,025,"Calhoun County, IA",4545,4375,170
19,027,"Carroll County, IA",11337,11049,288
19,029,"Cass County, IA",7301,7065,236
19,031,"Cedar County, IA",10914,10554,360
19,033,"Cerro Gordo County, IA",23235,22408,827
19,035,"Cherokee County, IA",6353,6124,229
19,037,"Chickasaw County, IA",6458,6175,283
19,039,"Clarke County, IA",4855,4693,162
19,041,"Clay County, IA",8764,8429,335
19,043,"Clayton County, IA",10354,9918,436
19,045,"Clinton County, IA",23936,22765,1171
19,047,"Crawford County, IA",8479,8020,459
19,049,"Dallas County, IA",46059,44856,1203
19,051,"Davis County, IA",4311,4130,181
19,053,"Decatur County, IA",4428,4287,141
19,055,"Delaware County, IA",10782,10412,370
19,057,"Des Moines County, IA",20141,19155,986
19,059,"Dickinson County, IA",10354,9912,442
19,061,"Dubuque County, IA",54968,53029,1939
19,063,"Emmet County, IA",5624,5387,237
19,065,"Fayette County, IA",10767,10293,474
19,067,"Floyd County, IA",8735,8420,315
19,069,"Franklin County, IA",5975,5770,205
19,071,"Fremont County, IA",4009,3878,131
19,073,"Greene County, IA",5697,5520,177
19,075,"Grundy County, IA",6669,6441,228
19,077,"Guthrie County, IA",5654,5452,202
19,079,"Hamilton County, IA",7178,6910,268
19,081,"Hancock County, IA",6424,6252,172
19,083,"Hardin County, IA",8617,8285,332
19,085,"Harrison County, IA",7489,7238,251
19,087,"Henry County, IA",9612,9273,339
19,089,"Howard County, IA",5357,5166,191
19,091,"Humboldt County, IA",5415,5260,155
19,093,"Ida County, IA",4046,3944,102
19,095,"Iowa County, IA",10613,10286,327
19,097,"Jackson County, IA",11119,10658,461
19,099,"Jasper County, IA",19345,18665,680
19,101,"Jefferson County, IA",9233,8897,336
19,103,"Johnson County, IA",84759,82580,2179
19,105,"Jones County, IA",10743,10287,456
19,107,"Keokuk County, IA",5349,5121,228
19,109,"Kossuth County, IA",8941,8709,232
19,111,"Lee County, IA",17549,16499,1050
19,113,"Linn County, IA",119414,115074,4340
19,115,"Louisa County, IA",6134,5896,238
19,117,"Lucas County, IA",4404,4266,138
19,119,"Lyon County, IA",7125,6981,144
19,121,"Madison County, IA",8294,8002,292
19,123,"Mahaska County, IA",11859,11424,435
19,125,"Marion County, IA",17538,17014,524
19,127,"Marshall County, IA",19234,18300,934
19,129,"Mills County, IA",7445,7176,269
19,131,"Mitchell County, IA",5911,5757,154
19,133,"Monona County, IA",4750,4558,192
19,135,"Monroe County, IA",3978,3796,182
19,137,"Montgomery County, IA",5139,4959,180
19,139,"Muscatine County, IA",22548,21697,851
19,141,"O'Brien County, IA",8405,8174,231
19,143,"Osceola County, IA",3662,3566,96
19,145,"Page County, IA",6498,6176,322
19,147,"Palo Alto County, IA",4992,4839,153
19,149,"Plymouth County, IA",15087,14705,382
19,151,"Pocahontas County, IA",4340,4217,123
19,153,"Polk County, IA",258689,249790,8899
19,155,"Pottawattamie County, IA",48517,46887,1630
19,157,"Poweshiek County, IA",10478,10122,356
19,159,"Ringgold County, IA",2621,2530,91
19,161,"Sac County, IA",5523,5359,164
19,163,"Scott County, IA",87175,83275,3900
19,165,"Shelby County, IA",6859,6659,200
19,167,"Sioux County, IA",20796,20323,473
19,169,"Story County, IA",57270,55939,1331
19,171,"Tama County, IA",9818,9411,407
19,173,"Taylor County, IA",3247,3152,95
19,175,"Union County, IA",6549,6302,247
19,177,"Van Buren County, IA",3880,3739,141
19,179,"Wapello County, IA",17981,16949,1032
19,181,"Warren County, IA",27252,26388,864
19,183,"Washington County, IA",12421,12060,361
19,185,"Wayne County, IA",2856,2749,107
19,187,"Webster County, IA",20538,19725,813
19,189,"Winnebago County, IA",5226,5046,180
19,191,"Winneshiek County, IA",12125,11702,423
19,193,"Woodbury County, IA",56044,54065,1979
19,195,"Worth County, IA",4292,4146,146
19,197,"Wright County, IA",6726,6452,274
20,001,"Allen County, KS",6467,6108,359
20,003,"Anderson County, KS",4193,4014,179
20,005,"Atchison County, KS",7078,6639,439
20,007,"Barber County, KS",2538,2445,93
20,009,"Barton County, KS",14087,13457,630
20,011,"Bourbon County, KS",7160,6813,347
20,013,"Brown County, KS",5189,5001,188
20,015,"Butler County, KS",32340,30994,1346
20,017,"Chase County, KS",1413,1364,49
20,019,"Chautauqua County, KS",1547,1467,80
20,021,"Cherokee County, KS",10336,9879,457
20,023,"Cheyenne County, KS",1351,1313,38
20,025,"Clark County, KS",1121,1090,31
20,027,"Clay County, KS",4053,3888,165
20,029,"Cloud County, KS",4275,4100,175
20,031,"Coffey County, KS",4303,4037,266
20,033,"Comanche County, KS",975,945,30
20,035,"Cowley County, KS",16985,16236,749
20,037,"Crawford County, KS",19001,18087,914
20,039,"Decatur County, KS",1298,1247,51
20,041,"Dickinson County, KS",9209,8803,406
20,043,"Doniphan County, KS",4294,4128,166
20,045,"Douglas County, KS",65567,63255,2312
20,047,"Edwards County, KS",1662,1612,50
20,049,"Elk County, KS",1194,1135,59
20,051,"Ellis County, KS",17090,16564,526
20,053,"Ellsworth County, KS",2846,2737,109
20,055,"Finney County, KS",20245,19620,625
20,057,"Ford County, KS",17966,17399,567
20,059,"Franklin County, KS",14291,13693,598
20,061,"Geary County, KS",12112,11431,681
20,063,"Gove County, KS",1458,1423,35
20,065,"Graham County, KS",1230,1176,54
20,067,"Grant County, KS",3792,3656,136
20,069,"Gray County, KS",3426,3348,78
20,071,"Greeley County, KS",916,897,19
20,073,"Greenwood County, KS",3337,3175,162
20,075,"Hamilton County, KS",1650,1606,44
20,077,"Harper County, KS",2894,2791,103
20,079,"Harvey County, KS",17283,16554,729
20,081,"Haskell County, KS",2315,2255,60
20,083,"Hodgeman County, KS",1034,1007,27
20,085,"Jackson County, KS",7293,7041,252
20,087,"Jefferson County, KS",10262,9864,398
20,089,"Jewell County, KS",1336,1279,57
20,091,"Johnson County, KS",329826,319111,10715
20,093,"Kearny County, KS",2067,2002,65
20,095,"Kingman County, KS",3544,3388,156
20,097,"Kiowa County, KS",1426,1387,39
20,099,"Labette County, KS",10782,10202,580
20,101,"Lane County, KS",814,789,25
20,103,"Leavenworth County, KS",35945,34402,1543
20,105,"Lincoln County, KS",1746,1686,60
20,107,"Linn County, KS",4362,4083,279
20,109,"Logan County, KS",1731,1687,44
20,111,"Lyon County, KS",16897,16206,691
20,113,"McPherson County, KS",16413,15897,516
20,115,"Marion County, KS",6148,5907,241
20,117,"Marshall County, KS",5588,5419,169
20,119,"Meade County, KS",2388,2324,64
20,121,"Miami County, KS",17098,16389,709
20,123,"Mitchell County, KS",3712,3590,122
20,125,"Montgomery County, KS",16070,15088,982
20,127,"Morris County, KS",3065,2947,118
20,129,"Morton County, KS",1350,1298,52
20,131,"Nemaha County, KS",5923,5765,158
20,133,"Neosho County, KS",6083,5648,435
20,135,"Ness County, KS",1429,1380,49
20,137,"Norton County, KS",2885,2815,70
20,139,"Osage County, KS",8094,7738,356
20,141,"Osborne County, KS",2068,1998,70
20,143,"Ottawa County, KS",3177,3057,120
20,145,"Pawnee County, KS",3224,3118,106
20,147,"Phillips County, KS",2870,2780,90
20,149,"Pottawatomie County, KS",12207,11782,425
20,151,"Pratt County, KS",5128,4920,208
20,153,"Rawlins County, KS",1552,1515,37
20,155,"Reno County, KS",30273,28944,1329
20,157,"Republic County, KS",2555,2485,70
20,159,"Rice County, KS",5329,5117,212
20,161,"Riley County, KS",35046,33861,1185
20,163,"Rooks County, KS",2681,2555,126
20,165,"Rush County, KS",1740,1671,69
20,167,"Russell County, KS",3589,3439,150
20,169,"Saline County, KS",30249,29124,1125
20,171,"Scott County, KS",2900,2829,71
20,173,"Sedgwick County, KS",248395,236886,11509
20,175,"Seward County, KS",10278,9831,447
20,177,"Shawnee County, KS",92101,88415,3686
20,179,"Sheridan County, KS",1456,1421,35
20,181,"Sherman County, KS",2954,2857,97
20,183,"Smith County, KS",2043,1978,65
20,185,"Stafford County, KS",2104,2027,77
20,187,"Stanton County, KS",1075,1045,30
20,189,"Stevens County, KS",2921,2806,115
20,191,"Sumner County, KS",10981,10517,464
20,193,"Thomas County, KS",4372,4252,120
20,195,"Trego County, KS",1483,1424,59
20,197,"Wabaunsee County, KS",3723,3590,133
20,199,"Wallace County, KS",863,840,23
20,201,"Washington County, KS",3097,2996,101
20,203,"Wichita County, KS",1211,1183,28
20,205,"Wilson County, KS",4133,3886,247
20,207,"Woodson County, KS",1624,1531,93
20,209,"Wyandotte County, KS",76774,72523,4251
21,001,"Adair County, KY",7083,6622,461
21,003,"Allen County, KY",8853,8477,376
21,005,"Anderson County, KY",11461,11006,455
21,007,"Ballard County, KY",3641,3320,321
21,009,"Barren County, KY",18859,17985,874
21,011,"Bath County, KY",4758,4412,346
21,013,"Bell County, KY",8654,7869,785
21,015,"Boone County, KY",67283,64755,2528
21,017,"Bourbon County, KY",9879,9416,463
21,019,"Boyd County, KY",18542,17058,1484
21,021,"Boyle County, KY",12312,11711,601
21,023,"Bracken County, KY",3831,3604,227
21,025,"Breathitt County, KY",3745,3381,364
21,027,"Breckinridge County, KY",7736,7256,480
21,029,"Bullitt County, KY",40534,38873,1661
21,031,"Butler County, KY",5161,4884,277
21,033,"Caldwell County, KY",5356,5067,289
21,035,"Calloway County, KY",18694,17860,834
21,037,"Campbell County, KY",48731,46893,1838
21,039,"Carlisle County, KY",2565,2401,164
21,041,"Carroll County, KY",5183,4930,253
21,043,"Carter County, KY",9934,8899,1035
21,045,"Casey County, KY",6689,6371,318
21,047,"Christian County, KY",24889,23381,1508
21,049,"Clark County, KY",17023,16215,808
21,051,"Clay County, KY",5449,4904,545
21,053,"Clinton County, KY",3749,3470,279
21,055,"Crittenden County, KY",4022,3814,208
21,057,"Cumberland County, KY",2890,2728,162
21,059,"Daviess County, KY",46692,44636,2056
21,061,"Edmonson County, KY",4804,4511,293
21,063,"Elliott County, KY",2096,1858,238
21,065,"Estill County, KY",5241,4936,305
21,067,"Fayette County, KY",171498,165460,6038
21,069,"Fleming County, KY",5945,5579,366
21,071,"Floyd County, KY",11447,10169,1278
21,073,"Franklin County, KY",24448,23466,982
21,075,"Fulton County, KY",2066,1925,141
21,077,"Gallatin County, KY",3904,3717,187
21,079,"Garrard County, KY",7527,7165,362
21,081,"Grant County, KY",11350,10806,544
21,083,"Graves County, KY",15305,14366,939
21,085,"Grayson County, KY",10726,10015,711
21,087,"Green County, KY",5002,4780,222
21,089,"Greenup County, KY",13884,12698,1186
21,091,"Hancock County, KY",4040,3826,214
21,093,"Hardin County, KY",47800,45688,2112
21,095,"Harlan County, KY",6738,5862,876
21,097,"Harrison County, KY",8494,8099,395
21,099,"Hart County, KY",7903,7534,369
21,101,"Henderson County, KY",21607,20594,1013
21,103,"Henry County, KY",7927,7606,321
21,105,"Hickman County, KY",1920,1807,113
21,107,"Hopkins County, KY",19637,18530,1107
21,109,"Jackson County, KY",4166,3841,325
21,111,"Jefferson County, KY",386769,369938,16831
21,113,"Jessamine County, KY",25667,24677,990
21,115,"Johnson County, KY",7010,6297,713
21,117,"Kenton County, KY",84740,81306,3434
21,119,"Knott County, KY",4556,4035,521
21,121,"Knox County, KY",9896,9115,781
21,123,"Larue County, KY",5900,5632,268
21,125,"Laurel County, KY",23913,22450,1463
21,127,"Lawrence County, KY",5039,4496,543
21,129,"Lee County, KY",1897,1714,183
21,131,"Leslie County, KY",2789,2417,372
21,133,"Letcher County, KY",6421,5634,787
21,135,"Lewis County, KY",4742,4281,461
21,137,"Lincoln County, KY",9148,8599,549
21,139,"Livingston County, KY",3687,3425,262
21,141,"Logan County, KY",11735,11225,510
21,143,"Lyon County, KY",2961,2789,172
21,145,"McCracken County, KY",29006,27354,1652
21,147,"McCreary County, KY",4600,4234,366
21,149,"McLean County, KY",4333,4127,206
21,151,"Madison County, KY",45115,43253,1862
21,153,"Magoffin County, KY",3139,2525,614
21,155,"Marion County, KY",9402,9010,392
21,157,"Marshall County, KY",14912,14058,854
21,159,"Martin County, KY",3083,2769,314
21,161,"Mason County, KY",7137,6687,450
21,163,"Meade County, KY",12092,11477,615
21,165,"Menifee County, KY",2393,2188,205
21,167,"Mercer County, KY",9891,9418,473
21,169,"Metcalfe County, KY",4120,3934,186
21,171,"Monroe County, KY",4603,4411,192
21,173,"Montgomery County, KY",11854,11101,753
21,175,"Morgan County, KY",4485,4130,355
21,177,"Muhlenberg County, KY",11361,10540,821
21,179,"Nelson County, KY",21706,20731,975
21,181,"Nicholas County, KY",3219,3036,183
21,183,"Ohio County, KY",9524,8894,630
21,185,"Oldham County, KY",31932,30862,1070
21,187,"Owen County, KY",5490,5257,233
21,189,"Owsley County, KY",1120,1012,108
21,191,"Pendleton County, KY",6851,6526,325
21,193,"Perry County, KY",8549,7634,915
21,195,"Pike County, KY",20225,18052,2173
21,197,"Powell County, KY",4958,4607,351
21,199,"Pulaski County, KY",25388,24021,1367
21,201,"Robertson County, KY",805,756,49
21,203,"Rockcastle County, KY",6683,6280,403
21,205,"Rowan County, KY",10574,9955,619
21,207,"Russell County, KY",6135,5626,509
21,209,"Scott County, KY",27992,26943,1049
21,211,"Shelby County, KY",23811,22972,839
21,213,"Simpson County, KY",8391,8021,370
21,215,"Spencer County, KY",9656,9294,362
21,217,"Taylor County, KY",12218,11622,596
21,219,"Todd County, KY",5303,5070,233
21,221,"Trigg County, KY",5819,5497,322
21,223,"Trimble County, KY",3869,3663,206
21,225,"Union County, KY",6163,5749,414
21,227,"Warren County, KY",61992,59600,2392
21,229,"Washington County, KY",6083,5825,258
21,231,"Wayne County, KY",7259,6708,551
21,233,"Webster County, KY",5834,5487,347
21,235,"Whitley County, KY",13349,12480,869
21,237,"Wolfe County, KY",1917,1725,192
21,239,"Woodford County, KY",14762,14294,468
22,001,"Acadia Parish, LA",24540,22724,1816
22,003,"Allen Parish, LA",8910,8337,573
22,005,"Ascension Parish, LA",62060,59019,3041
22,007,"Assumption Parish, LA",9218,8443,775
22,009,"Avoyelles Parish, LA",15702,14591,1111
22,011,"Beauregard Parish, LA",15083,14169,914
22,013,"Bienville Parish, LA",5671,5239,432
22,015,"Bossier Parish, LA",57649,54581,3068
22,017,"Caddo Parish, LA",107169,100070,7099
22,019,"Calcasieu Parish, LA",103001,98072,4929
22,021,"Caldwell Parish, LA",3987,3682,305
22,023,"Cameron Parish, LA",3822,3654,168
22,025,"Catahoula Parish, LA",3428,3109,319
22,027,"Claiborne Parish, LA",5958,5560,398
22,029,"Concordia Parish, LA",7260,6659,601
22,031,"De Soto Parish, LA",10902,10100,802
22,033,"East Baton Rouge Parish, LA",232408,220408,12000
22,035,"East Carroll Parish, LA",2141,1893,248
22,037,"East Feliciana Parish, LA",8114,7645,469
22,039,"Evangeline Parish, LA",12686,11745,941
22,041,"Franklin Parish, LA",7288,6627,661
22,043,"Grant Parish, LA",8334,7752,582
22,045,"Iberia Parish, LA",30150,27315,2835
22,047,"Iberville Parish, LA",14126,13157,969
22,049,"Jackson Parish, LA",7092,6696,396
22,051,"Jefferson Parish, LA",216748,205292,11456
22,053,"Jefferson Davis Parish, LA",13592,12773,819
22,055,"Lafayette Parish, LA",114488,107456,7032
22,057,"Lafourche Parish, LA",43345,40617,2728
22,059,"LaSalle Parish, LA",6278,5862,416
22,061,"Lincoln Parish, LA",21490,20153,1337
22,063,"Livingston Parish, LA",68759,65272,3487
22,065,"Madison Parish, LA",3840,3495,345
22,067,"Morehouse Parish, LA",10635,9603,1032
22,069,"Natchitoches Parish, LA",16733,15606,1127
22,071,"Orleans Parish, LA",180187,169604,10583
22,073,"Ouachita Parish, LA",71640,67279,4361
22,075,"Plaquemines Parish, LA",10197,9651,546
22,077,"Pointe Coupee Parish, LA",9972,9325,647
22,079,"Rapides Parish, LA",57346,53805,3541
22,081,"Red River Parish, LA",3813,3583,230
22,083,"Richland Parish, LA",8455,7827,628
22,085,"Sabine Parish, LA",9150,8516,634
22,087,"St. Bernard Parish, LA",19571,18379,1192
22,089,"St. Charles Parish, LA",25351,24004,1347
22,091,"St. Helena Parish, LA",4395,4058,337
22,093,"St. James Parish, LA",9618,8898,720
22,095,"St. John the Baptist Parish, LA",20080,18706,1374
22,097,"St. Landry Parish, LA",32850,30194,2656
22,099,"St. Martin Parish, LA",22992,21208,1784
22,101,"St. Mary Parish, LA",21967,19903,2064
22,103,"St. Tammany Parish, LA",117626,111775,5851
22,105,"Tangipahoa Parish, LA",54229,50567,3662
22,107,"Tensas Parish, LA",1628,1468,160
22,109,"Terrebonne Parish, LA",49011,45592,3419
22,111,"Union Parish, LA",9254,8647,607
22,113,"Vermilion Parish, LA",24732,22848,1884
22,115,"Vernon Parish, LA",16949,15720,1229
22,117,"Washington Parish, LA",16966,15773,1193
22,119,"Webster Parish, LA",15218,13919,1299
22,121,"West Baton Rouge Parish, LA",13256,12549,707
22,123,"West Carroll Parish, LA",4108,3617,491
22,125,"West Feliciana Parish, LA",5334,5058,276
22,127,"Winn Parish, LA",5191,4788,403
23,001,"Androscoggin County, ME",55482,53500,1982
23,003,"Aroostook County, ME",31548,29842,1706
23,005,"Cumberland County, ME",162396,157678,4718
23,007,"Franklin County, ME",14483,13838,645
23,009,"Hancock County, ME",29245,27934,1311
23,011,"Kennebec County, ME",62459,60193,2266
23,013,"Knox County, ME",20762,20034,728
23,015,"Lincoln County, ME",17057,16429,628
23,017,"Oxford County, ME",26635,25409,1226
23,019,"Penobscot County, ME",77183,73852,3331
23,021,"Piscataquis County, ME",7494,7123,371
23,023,"Sagadahoc County, ME",19241,18673,568
23,025,"Somerset County, ME",23544,22225,1319
23,027,"Waldo County, ME",20914,20041,873
23,029,"Washington County, ME",14042,13268,774
23,031,"York County, ME",111436,107686,3750
24,001,"Allegany County, MD",32365,30416,1949
24,003,"Anne Arundel County, MD",303234,292085,11149
24,005,"Baltimore County, MD",444683,424736,19947
24,009,"Calvert County, MD",48750,46930,1820
24,011,"Caroline County, MD",17643,16830,813
24,013,"Carroll County, MD",93015,89753,3262
24,015,"Cecil County, MD",52564,49912,2652
24,017,"Charles County, MD",83812,80379,3433
24,019,"Dorchester County, MD",15863,14911,952
24,021,"Frederick County, MD",128533,123692,4841
24,023,"Garrett County, MD",15483,14635,848
24,025,"Harford County, MD",136199,130653,5546
24,027,"Howard County, MD",179120,173421,5699
24,029,"Kent County, MD",10230,9750,480
24,031,"Montgomery County, MD",544649,526510,18139
24,033,"Prince George's County, MD",499860,478398,21462
24,035,"Queen Anne's County, MD",26567,25564,1003
24,037,"St. Mary's County, MD",54730,52486,2244
24,039,"Somerset County, MD",9219,8573,646
24,041,"Talbot County, MD",19517,18727,790
24,043,"Washington County, MD",75300,71575,3725
24,045,"Wicomico County, MD",50359,47331,3028
24,047,"Worcester County, MD",25158,22900,2258
24,510,"Baltimore city, MD",289071,270665,18406
25,001,"Barnstable County, MA",111677,106010,5667
25,003,"Berkshire County, MA",64396,61392,3004
25,005,"Bristol County, MA",290690,275900,14790
25,007,"Dukes County, MA",9357,8857,500
25,009,"Essex County, MA",410554,393617,16937
25,011,"Franklin County, MA",39542,38108,1434
25,013,"Hampden County, MA",222228,210141,12087
25,015,"Hampshire County, MA",88079,84767,3312
25,017,"Middlesex County, MA",873570,844884,28686
25,019,"Nantucket County/town, MA",7050,6727,323
25,021,"Norfolk County, MA",372572,359531,13041
25,023,"Plymouth County, MA",270543,259120,11423
25,025,"Suffolk County, MA",427208,411526,15682
25,027,"Worcester County, MA",430035,411749,18286
26,001,"Alcona County, MI",3839,3543,296
26,003,"Alger County, MI",3274,3002,272
26,005,"Allegan County, MI",61447,59033,2414
26,007,"Alpena County, MI",13689,12867,822
26,009,"Antrim County, MI",10098,9378,720
26,011,"Arenac County, MI",6140,5627,513
26,013,"Baraga County, MI",3230,2962,268
26,015,"Barry County, MI",30829,29584,1245
26,017,"Bay County, MI",52039,49168,2871
26,019,"Benzie County, MI",8864,8276,588
26,021,"Berrien County, MI",74004,70297,3707
26,023,"Branch County, MI",19157,18224,933
26,025,"Calhoun County, MI",64585,61453,3132
26,027,"Cass County, MI",24412,23254,1158
26,029,"Charlevoix County, MI",13093,12362,731
26,031,"Cheboygan County, MI",10851,9821,1030
26,033,"Chippewa County, MI",16438,15165,1273
26,035,"Clare County, MI",11991,11106,885
26,037,"Clinton County, MI",40607,39093,1514
26,039,"Crawford County, MI",5383,4972,411
26,041,"Delta County, MI",17169,16033,1136
26,043,"Dickinson County, MI",12539,11882,657
26,045,"Eaton County, MI",57051,54670,2381
26,047,"Emmet County, MI",17649,16489,1160
26,049,"Genesee County, MI",180586,170150,10436
26,051,"Gladwin County, MI",9915,9216,699
26,053,"Gogebic County, MI",6354,5961,393
26,055,"Grand Traverse County, MI",49515,47371,2144
26,057,"Gratiot County, MI",18220,17266,954
26,059,"Hillsdale County, MI",21233,20150,1083
26,061,"Houghton County, MI",16612,15585,1027
26,063,"Huron County, MI",16042,15204,838
26,065,"Ingham County, MI",149317,142853,6464
26,067,"Ionia County, MI",29735,28468,1267
26,069,"Iosco County, MI",10141,9395,746
26,071,"Iron County, MI",5233,4891,342
26,073,"Isabella County, MI",35448,33768,1680
26,075,"Jackson County, MI",74612,70963,3649
26,077,"Kalamazoo County, MI",132365,126947,5418
26,079,"Kalkaska County, MI",7743,7182,561
26,081,"Kent County, MI",351257,338786,12471
26,083,"Keweenaw County, MI",944,862,82
26,085,"Lake County, MI",3764,3479,285
26,087,"Lapeer County, MI",40678,38080,2598
26,089,"Leelanau County, MI",10603,10083,520
26,091,"Lenawee County, MI",47487,45278,2209
26,093,"Livingston County, MI",99935,95886,4049
26,095,"Luce County, MI",2409,2245,164
26,097,"Mackinac County, MI",5208,4689,519
26,099,"Macomb County, MI",435441,412956,22485
26,101,"Manistee County, MI",10565,9866,699
26,103,"Marquette County, MI",33412,31489,1923
26,105,"Mason County, MI",14316,13476,840
26,107,"Mecosta County, MI",19160,18071,1089
26,109,"Menominee County, MI",11281,10693,588
26,111,"Midland County, MI",41136,39179,1957
26,113,"Missaukee County, MI",7045,6622,423
26,115,"Monroe County, MI",76614,73276,3338
26,117,"Montcalm County, MI",28000,26501,1499
26,119,"Montmorency County, MI",3069,2755,314
26,121,"Muskegon County, MI",77659,73383,4276
26,123,"Newaygo County, MI",23394,22239,1155
26,125,"Oakland County, MI",652450,625608,26842
26,127,"Oceana County, MI",12360,11446,914
26,129,"Ogemaw County, MI",8262,7612,650
26,131,"Ontonagon County, MI",2209,2019,190
26,133,"Osceola County, MI",10462,9859,603
26,135,"Oscoda County, MI",2915,2700,215
26,137,"Otsego County, MI",11721,11017,704
26,139,"Ottawa County, MI",155788,150491,5297
26,141,"Presque Isle County, MI",5304,4792,512
26,143,"Roscommon County, MI",7894,7219,675
26,145,"Saginaw County, MI",88762,83977,4785
26,147,"St. Clair County, MI",74615,70103,4512
26,149,"St. Joseph County, MI",29200,27985,1215
26,151,"Sanilac County, MI",19470,18247,1223
26,153,"Schoolcraft County, MI",3399,3087,312
26,155,"Shiawassee County, MI",33510,31723,1787
26,157,"Tuscola County, MI",24253,22711,1542
26,159,"Van Buren County, MI",35566,33502,2064
26,161,"Washtenaw County, MI",192000,184914,7086
26,163,"Wayne County, MI",778939,730549,48390
26,165,"Wexford County, MI",14741,13868,873
27,001,"Aitkin County, MN",7024,6531,493
27,003,"Anoka County, MN",191787,184641,7146
27,005,"Becker County, MN",18547,17699,848
27,007,"Beltrami County, MN",23662,22427,1235
27,009,"Benton County, MN",21764,20803,961
27,011,"Big Stone County, MN",2702,2572,130
27,013,"Blue Earth County, MN",39595,38325,1270
27,015,"Brown County, MN",14512,13904,608
27,017,"Carlton County, MN",17731,16791,940
27,019,"Carver County, MN",56292,54436,1856
27,021,"Cass County, MN",14150,13183,967
27,023,"Chippewa County, MN",6963,6648,315
27,025,"Chisago County, MN",29128,27869,1259
27,027,"Clay County, MN",35591,34368,1223
27,029,"Clearwater County, MN",4713,4260,453
27,031,"Cook County, MN",3093,2952,141
27,033,"Cottonwood County, MN",5530,5134,396
27,035,"Crow Wing County, MN",31820,30198,1622
27,037,"Dakota County, MN",234941,226978,7963
27,039,"Dodge County, MN",11549,11120,429
27,041,"Douglas County, MN",20218,19513,705
27,043,"Faribault County, MN",7316,6995,321
27,045,"Fillmore County, MN",11492,11028,464
27,047,"Freeborn County, MN",16276,15654,622
27,049,"Goodhue County, MN",26830,25833,997
27,051,"Grant County, MN",3285,3131,154
27,053,"Hennepin County, MN",685106,662298,22808
27,055,"Houston County, MN",10593,10179,414
27,057,"Hubbard County, MN",9790,9154,636
27,059,"Isanti County, MN",20661,19697,964
27,061,"Itasca County, MN",22014,20132,1882
27,063,"Jackson County, MN",6094,5819,275
27,065,"Kanabec County, MN",8987,8402,585
27,067,"Kandiyohi County, MN",24175,23256,919
27,069,"Kittson County, MN",2403,2293,110
27,071,"Koochiching County, MN",6159,5636,523
27,073,"Lac qui Parle County, MN",3617,3462,155
27,075,"Lake County, MN",5414,5069,345
27,077,"Lake of the Woods County, MN",2382,2267,115
27,079,"Le Sueur County, MN",15550,14790,760
27,081,"Lincoln County, MN",3380,3257,123
27,083,"Lyon County, MN",15176,14637,539
27,085,"McLeod County, MN",19765,18893,872
27,087,"Mahnomen County, MN",2388,2250,138
27,089,"Marshall County, MN",5615,5204,411
27,091,"Martin County, MN",10455,10025,430
27,093,"Meeker County, MN",13254,12659,595
27,095,"Mille Lacs County, MN",12717,11958,759
27,097,"Morrison County, MN",17856,16853,1003
27,099,"Mower County, MN",20506,19858,648
27,101,"Murray County, MN",4953,4719,234
27,103,"Nicollet County, MN",20343,19767,576
27,105,"Nobles County, MN",11450,11018,432
27,107,"Norman County, MN",3439,3275,164
27,109,"Olmsted County, MN",85163,82628,2535
27,111,"Otter Tail County, MN",31275,29913,1362
27,113,"Pennington County, MN",9039,8518,521
27,115,"Pine County, MN",14830,13963,867
27,117,"Pipestone County, MN",4899,4712,187
27,119,"Polk County, MN",17136,16392,744
27,121,"Pope County, MN",6299,6075,224
27,123,"Ramsey County, MN",282227,272058,10169
27,125,"Red Lake County, MN",2289,2121,168
27,127,"Redwood County, MN",8315,7974,341
27,129,"Renville County, MN",8411,7969,442
27,131,"Rice County, MN",36083,34818,1265
27,133,"Rock County, MN",5907,5770,137
27,135,"Roseau County, MN",8244,7822,422
27,137,"St. Louis County, MN",102556,96688,5868
27,139,"Scott County, MN",80660,78068,2592
27,141,"Sherburne County, MN",50664,48603,2061
27,143,"Sibley County, MN",8488,8125,363
27,145,"Stearns County, MN",88889,85541,3348
27,147,"Steele County, MN",21176,20422,754
27,149,"Stevens County, MN",5647,5478,169
27,151,"Swift County, MN",5045,4773,272
27,153,"Todd County, MN",12900,12292,608
27,155,"Traverse County, MN",1705,1639,66
27,157,"Wabasha County, MN",12007,11564,443
27,159,"Wadena County, MN",6246,5875,371
27,161,"Waseca County, MN",9461,9055,406
27,163,"Washington County, MN",138733,134104,4629
27,165,"Watonwan County, MN",6573,6253,320
27,167,"Wilkin County, MN",3718,3597,121
27,169,"Winona County, MN",29250,28213,1037
27,171,"Wright County, MN",73060,70243,2817
27,173,"Yellow Medicine County, MN",5475,5265,210
28,001,"Adams County, MS",11207,10261,946
28,003,"Alcorn County, MS",15747,14911,836
28,005,"Amite County, MS",4489,4153,336
28,007,"Attala County, MS",6984,6506,478
28,009,"Benton County, MS",3034,2826,208
28,011,"Bolivar County, MS",13346,12360,986
28,013,"Calhoun County, MS",6156,5819,337
28,015,"Carroll County, MS",3549,3286,263
28,017,"Chickasaw County, MS",7062,6588,474
28,019,"Choctaw County, MS",3710,3496,214
28,021,"Claiborne County, MS",3082,2725,357
28,023,"Clarke County, MS",6049,5631,418
28,025,"Clay County, MS",7988,7326,662
28,027,"Coahoma County, MS",9181,8368,813
28,029,"Copiah County, MS",11230,10482,748
28,031,"Covington County, MS",8116,7666,450
28,033,"DeSoto County, MS",86854,83114,3740
28,035,"Forrest County, MS",33231,31288,1943
28,037,"Franklin County, MS",2841,2633,208
28,039,"George County, MS",8777,8113,664
28,041,"Greene County, MS",4268,3951,317
28,043,"Grenada County, MS",9563,9063,500
28,045,"Hancock County, MS",18788,17620,1168
28,047,"Harrison County, MS",86334,81468,4866
28,049,"Hinds County, MS",109481,103402,6079
28,051,"Holmes County, MS",5958,5290,668
28,053,"Humphreys County, MS",2366,2091,275
28,055,"Issaquena County, MS",400,343,57
28,057,"Itawamba County, MS",10354,9818,536
28,059,"Jackson County, MS",58850,54898,3952
28,061,"Jasper County, MS",6166,5684,482
28,063,"Jefferson County, MS",2221,1884,337
28,065,"Jefferson Davis County, MS",4165,3814,351
28,067,"Jones County, MS",25680,24075,1605
28,069,"Kemper County, MS",3540,3225,315
28,071,"Lafayette County, MS",25868,24579,1289
28,073,"Lamar County, MS",29464,28097,1367
28,075,"Lauderdale County, MS",31639,29740,1899
28,077,"Lawrence County, MS",4655,4317,338
28,079,"Leake County, MS",7720,7242,478
28,081,"Lee County, MS",40620,38598,2022
28,083,"Leflore County, MS",10296,9343,953
28,085,"Lincoln County, MS",14358,13524,834
28,087,"Lowndes County, MS",25405,23813,1592
28,089,"Madison County, MS",53109,50769,2340
28,091,"Marion County, MS",10221,9537,684
28,093,"Marshall County, MS",14492,13600,892
28,095,"Monroe County, MS",15569,14567,1002
28,097,"Montgomery County, MS",4218,3943,275
28,099,"Neshoba County, MS",10652,10027,625
28,101,"Newton County, MS",8603,8085,518
28,103,"Noxubee County, MS",3949,3616,333
28,105,"Oktibbeha County, MS",22946,21675,1271
28,107,"Panola County, MS",13128,12143,985
28,109,"Pearl River County, MS",23116,21706,1410
28,111,"Perry County, MS",4339,4023,316
28,113,"Pike County, MS",14608,13597,1011
28,115,"Pontotoc County, MS",14367,13673,694
28,117,"Prentiss County, MS",11011,10398,613
28,119,"Quitman County, MS",2607,2348,259
28,121,"Rankin County, MS",74573,71558,3015
28,123,"Scott County, MS",13197,12579,618
28,125,"Sharkey County, MS",1708,1555,153
28,127,"Simpson County, MS",10882,10278,604
28,129,"Smith County, MS",6707,6346,361
28,131,"Stone County, MS",6465,6021,444
28,133,"Sunflower County, MS",8307,7520,787
28,135,"Tallahatchie County, MS",5711,5316,395
28,137,"Tate County, MS",12026,11308,718
28,139,"Tippah County, MS",9353,8823,530
28,141,"Tishomingo County, MS",8217,7757,460
28,143,"Tunica County, MS",4589,4256,333
28,145,"Union County, MS",13593,12979,614
28,147,"Walthall County, MS",5016,4621,395
28,149,"Warren County, MS",20715,19377,1338
28,151,"Washington County, MS",17691,16068,1623
28,153,"Wayne County, MS",7503,6943,560
28,155,"Webster County, MS",3889,3640,249
28,157,"Wilkinson County, MS",2825,2532,293
28,159,"Winston County, MS",7076,6563,513
28,161,"Yalobusha County, MS",4864,4553,311
28,163,"Yazoo County, MS",9208,8515,693
29,001,"Adair County, MO",10359,9772,587
29,003,"Andrew County, MO",10021,9649,372
29,005,"Atchison County, MO",2838,2709,129
29,007,"Audrain County, MO",11120,10649,471
29,009,"Barry County, MO",15175,14495,680
29,011,"Barton County, MO",5313,5036,277
29,013,"Bates County, MO",8146,7711,435
29,015,"Benton County, MO",7250,6811,439
29,017,"Bollinger County, MO",5454,5169,285
29,019,"Boone County, MO",98042,94825,3217
29,021,"Buchanan County, MO",46642,44741,1901
29,023,"Butler County, MO",18771,17701,1070
29,025,"Caldwell County, MO",4469,4259,210
29,027,"Callaway County, MO",21800,20908,892
29,029,"Camden County, MO",18705,17620,1085
29,031,"Cape Girardeau County, MO",40711,38952,1759
29,033,"Carroll County, MO",4762,4507,255
29,035,"Carter County, MO",2540,2360,180
29,037,"Cass County, MO",54449,52196,2253
29,039,"Cedar County, MO",5789,5501,288
29,041,"Chariton County, MO",3851,3684,167
29,043,"Christian County, MO",43307,41613,1694
29,045,"Clark County, MO",3366,3119,247
29,047,"Clay County, MO",133855,128647,5208
29,049,"Clinton County, MO",10999,10536,463
29,051,"Cole County, MO",39380,37982,1398
29,053,"Cooper County, MO",7473,7106,367
29,055,"Crawford County, MO",10817,10240,577
29,057,"Dade County, MO",3583,3423,160
29,059,"Dallas County, MO",6947,6567,380
29,061,"Daviess County, MO",4111,3953,158
29,063,"DeKalb County, MO",5077,4856,221
29,065,"Dent County, MO",6195,5862,333
29,067,"Douglas County, MO",5075,4767,308
29,069,"Dunklin County, MO",12820,11767,1053
29,071,"Franklin County, MO",52613,50323,2290
29,073,"Gasconade County, MO",7692,7361,331
29,075,"Gentry County, MO",3584,3451,133
29,077,"Greene County, MO",148413,142801,5612
29,079,"Grundy County, MO",4897,4674,223
29,081,"Harrison County, MO",3968,3801,167
29,083,"Henry County, MO",9880,9388,492
29,085,"Hickory County, MO",3691,3484,207
29,087,"Holt County, MO",2682,2595,87
29,089,"Howard County, MO",5024,4802,222
29,091,"Howell County, MO",16097,15079,1018
29,093,"Iron County, MO",3710,3445,265
29,095,"Jackson County, MO",363794,345196,18598
29,097,"Jasper County, MO",57668,55277,2391
29,099,"Jefferson County, MO",117502,112461,5041
29,101,"Johnson County, MO",23156,22024,1132
29,103,"Knox County, MO",1982,1910,72
29,105,"Laclede County, MO",16142,15263,879
29,107,"Lafayette County, MO",17173,16434,739
29,109,"Lawrence County, MO",17766,16992,774
29,111,"Lewis County, MO",5132,4900,232
29,113,"Lincoln County, MO",27200,25980,1220
29,115,"Linn County, MO",5266,4914,352
29,117,"Livingston County, MO",7342,7056,286
29,119,"McDonald County, MO",10462,10010,452
29,121,"Macon County, MO",7606,7243,363
29,123,"Madison County, MO",5472,5172,300
29,125,"Maries County, MO",3906,3710,196
29,127,"Marion County, MO",14557,13935,622
29,129,"Mercer County, MO",1926,1838,88
29,131,"Miller County, MO",11871,11257,614
29,133,"Mississippi County, MO",6208,5797,411
29,135,"Moniteau County, MO",7463,7140,323
29,137,"Monroe County, MO",4157,3956,201
29,139,"Montgomery County, MO",5743,5481,262
29,141,"Morgan County, MO",7958,7491,467
29,143,"New Madrid County, MO",8230,7468,762
29,145,"Newton County, MO",28186,26960,1226
29,147,"Nodaway County, MO",10838,10334,504
29,149,"Oregon County, MO",4110,3864,246
29,151,"Osage County, MO",7219,6974,245
29,153,"Ozark County, MO",3627,3364,263
29,155,"Pemiscot County, MO",7023,6401,622
29,157,"Perry County, MO",10068,9710,358
29,159,"Pettis County, MO",20602,19588,1014
29,161,"Phelps County, MO",19485,18562,923
29,163,"Pike County, MO",8056,7694,362
29,165,"Platte County, MO",56646,54601,2045
29,167,"Polk County, MO",14205,13516,689
29,169,"Pulaski County, MO",14461,13678,783
29,171,"Putnam County, MO",2452,2340,112
29,173,"Ralls County, MO",5621,5395,226
29,175,"Randolph County, MO",10481,9933,548
29,177,"Ray County, MO",11135,10588,547
29,179,"Reynolds County, MO",2680,2507,173
29,181,"Ripley County, MO",5329,4954,375
29,183,"St. Charles County, MO",220910,213165,7745
29,185,"St. Clair County, MO",3912,3667,245
29,186,"Ste. Genevieve County, MO",8980,8563,417
29,187,"St. Francois County, MO",26210,24770,1440
29,189,"St. Louis County, MO",531064,508770,22294
29,195,"Saline County, MO",10726,10227,499
29,197,"Schuyler County, MO",1904,1783,121
29,199,"Scotland County, MO",2452,2351,101
29,201,"Scott County, MO",19950,18810,1140
29,203,"Shannon County, MO",3322,3079,243
29,205,"Shelby County, MO",3069,2940,129
29,207,"Stoddard County, MO",13286,12436,850
29,209,"Stone County, MO",13417,12478,939
29,211,"Sullivan County, MO",2768,2609,159
29,213,"Taney County, MO",26311,24362,1949
29,215,"Texas County, MO",9314,8731,583
29,217,"Vernon County, MO",9598,9133,465
29,219,"Warren County, MO",17480,16750,730
29,221,"Washington County, MO",10331,9677,654
29,223,"Wayne County, MO",5653,5351,302
29,225,"Webster County, MO",16883,16054,829
29,227,"Worth County, MO",1210,1174,36
29,229,"Wright County, MO",7595,7146,449
29,510,"St. Louis city, MO",157198,148669,8529
30,001,"Beaverhead County, MT",5068,4894,174
30,003,"Big Horn County, MT",5539,5123,416
30,005,"Blaine County, MT",2369,2257,112
30,007,"Broadwater County, MT",2551,2421,130
30,009,"Carbon County, MT",5418,5196,222
30,011,"Carter County, MT",696,676,20
30,013,"Cascade County, MT",37781,36224,1557
30,015,"Chouteau County, MT",2513,2415,98
30,017,"Custer County, MT",6235,6007,228
30,019,"Daniels County, MT",934,909,25
30,021,"Dawson County, MT",4601,4418,183
30,023,"Deer Lodge County, MT",5296,5087,209
30,025,"Fallon County, MT",1810,1742,68
30,027,"Fergus County, MT",5763,5528,235
30,029,"Flathead County, MT",45960,43298,2662
30,031,"Gallatin County, MT",62060,60245,1815
30,033,"Garfield County, MT",763,740,23
30,035,"Glacier County, MT",5826,5310,516
30,037,"Golden Valley County, MT",378,361,17
30,039,"Granite County, MT",1632,1532,100
30,041,"Hill County, MT",7797,7448,349
30,043,"Jefferson County, MT",5669,5399,270
30,045,"Judith Basin County, MT",932,899,33
30,047,"Lake County, MT",13078,12435,643
30,049,"Lewis and Clark County, MT",35167,33961,1206
30,051,"Liberty County, MT",988,956,32
30,053,"Lincoln County, MT",7940,7200,740
30,055,"McCone County, MT",1042,1021,21
30,057,"Madison County, MT",4412,4239,173
30,059,"Meagher County, MT",915,877,38
30,061,"Mineral County, MT",1688,1556,132
30,063,"Missoula County, MT",61361,58972,2389
30,065,"Musselshell County, MT",2294,2172,122
30,067,"Park County, MT",8406,8032,374
30,069,"Petroleum County, MT",277,264,13
30,071,"Phillips County, MT",1935,1829,106
30,073,"Pondera County, MT",2864,2739,125
30,075,"Powder River County, MT",1066,1040,26
30,077,"Powell County, MT",2868,2718,150
30,079,"Prairie County, MT",526,508,18
30,081,"Ravalli County, MT",19569,18594,975
30,083,"Richland County, MT",6213,5893,320
30,085,"Roosevelt County, MT",4687,4428,259
30,087,"Rosebud County, MT",4107,3874,233
30,089,"Sanders County, MT",4758,4377,381
30,091,"Sheridan County, MT",1958,1892,66
30,093,"Silver Bow County, MT",17184,16421,763
30,095,"Stillwater County, MT",4808,4609,199
30,097,"Sweet Grass County, MT",1796,1738,58
30,099,"Teton County, MT",2828,2722,106
30,101,"Toole County, MT",2224,2144,80
30,103,"Treasure County, MT",353,337,16
30,105,"Valley County, MT",4400,4246,154
30,107,"Wheatland County, MT",797,755,42
30,109,"Wibaux County, MT",513,492,21
30,111,"Yellowstone County, MT",81129,78099,3030
31,001,"Adams County, NE",16749,16226,523
31,003,"Antelope County, NE",3613,3519,94
31,005,"Arthur County, NE",228,215,13
31,007,"Banner County, NE",420,405,15
31,009,"Blaine County, NE",267,255,12
31,011,"Boone County, NE",3021,2942,79
31,013,"Box Butte County, NE",5675,5472,203
31,015,"Boyd County, NE",1105,1072,33
31,017,"Brown County, NE",1388,1337,51
31,019,"Buffalo County, NE",27371,26687,684
31,021,"Burt County, NE",3566,3435,131
31,023,"Butler County, NE",4652,4503,149
31,025,"Cass County, NE",13217,12774,443
31,027,"Cedar County, NE",4595,4478,117
31,029,"Chase County, NE",2304,2257,47
31,031,"Cherry County, NE",3491,3412,79
31,033,"Cheyenne County, NE",5483,5329,154
31,035,"Clay County, NE",3340,3237,103
31,037,"Colfax County, NE",5582,5424,158
31,039,"Cuming County, NE",4742,4606,136
31,041,"Custer County, NE",6387,6238,149
31,043,"Dakota County, NE",10969,10515,454
31,045,"Dawes County, NE",5243,5089,154
31,047,"Dawson County, NE",13037,12653,384
31,049,"Deuel County, NE",1067,1039,28
31,051,"Dixon County, NE",3086,2984,102
31,053,"Dodge County, NE",19237,18649,588
31,055,"Douglas County, NE",289613,280038,9575
31,057,"Dundy County, NE",1202,1176,26
31,059,"Fillmore County, NE",3201,3113,88
31,061,"Franklin County, NE",1509,1464,45
31,063,"Frontier County, NE",1578,1534,44
31,065,"Furnas County, NE",2731,2655,76
31,067,"Gage County, NE",11112,10749,363
31,069,"Garden County, NE",1194,1155,39
31,071,"Garfield County, NE",1162,1133,29
31,073,"Gosper County, NE",1062,1035,27
31,075,"Grant County, NE",455,445,10
31,077,"Greeley County, NE",1241,1203,38
31,079,"Hall County, NE",31581,30429,1152
31,081,"Hamilton County, NE",4679,4549,130
31,083,"Harlan County, NE",1767,1723,44
31,085,"Hayes County, NE",593,579,14
31,087,"Hitchcock County, NE",1313,1266,47
31,089,"Holt County, NE",5892,5747,145
31,091,"Hooker County, NE",394,380,14
31,093,"Howard County, NE",3318,3209,109
31,095,"Jefferson County, NE",4245,4143,102
31,097,"Johnson County, NE",2103,2037,66
31,099,"Kearney County, NE",3761,3673,88
31,101,"Keith County, NE",4643,4509,134
31,103,"Keya Paha County, NE",623,610,13
31,105,"Kimball County, NE",1982,1902,80
31,107,"Knox County, NE",4745,4601,144
31,109,"Lancaster County, NE",169981,165281,4700
31,111,"Lincoln County, NE",18815,18238,577
31,113,"Logan County, NE",486,472,14
31,115,"Loup County, NE",398,384,14
31,117,"McPherson County, NE",466,455,11
31,119,"Madison County, NE",19266,18738,528
31,121,"Merrick County, NE",4056,3910,146
31,123,"Morrill County, NE",2663,2579,84
31,125,"Nance County, NE",2011,1956,55
31,127,"Nemaha County, NE",3637,3505,132
31,129,"Nuckolls County, NE",2380,2311,69
31,131,"Otoe County, NE",8307,8026,281
31,133,"Pawnee County, NE",1663,1626,37
31,135,"Perkins County, NE",1830,1790,40
31,137,"Phelps County, NE",4957,4833,124
31,139,"Pierce County, NE",4168,4059,109
31,141,"Platte County, NE",17068,16476,592
31,143,"Polk County, NE",2898,2821,77
31,145,"Red Willow County, NE",6009,5840,169
31,147,"Richardson County, NE",4261,4124,137
31,149,"Rock County, NE",896,873,23
31,151,"Saline County, NE",7391,7164,227
31,153,"Sarpy County, NE",92568,89882,2686
31,155,"Saunders County, NE",10935,10600,335
31,157,"Scotts Bluff County, NE",18951,18290,661
31,159,"Seward County, NE",8802,8551,251
31,161,"Sheridan County, NE",2753,2675,78
31,163,"Sherman County, NE",1726,1671,55
31,165,"Sioux County, NE",788,767,21
31,167,"Stanton County, NE",3460,3370,90
31,169,"Thayer County, NE",2919,2848,71
31,171,"Thomas County, NE",451,436,15
31,173,"Thurston County, NE",2995,2852,143
31,175,"Valley County, NE",2104,2045,59
31,177,"Washington County, NE",11169,10813,356
31,179,"Wayne County, NE",5656,5506,150
31,181,"Webster County, NE",1722,1668,54
31,183,"Wheeler County, NE",569,557,12
31,185,"York County, NE",7365,7166,199
32,001,"Churchill County, NV",10304,9724,580
32,003,"Clark County, NV",1040292,978799,61493
32,005,"Douglas County, NV",22069,20810,1259
32,007,"Elko County, NV",26709,25497,1212
32,009,"Esmeralda County, NV",511,487,24
32,011,"Eureka County, NV",980,935,45
32,013,"Humboldt County, NV",7990,7545,445
32,015,"Lander County, NV",3106,2909,197
32,017,"Lincoln County, NV",1969,1863,106
32,019,"Lyon County, NV",21106,19500,1606
32,021,"Mineral County, NV",1994,1866,128
32,023,"Nye County, NV",15905,14721,1184
32,027,"Pershing County, NV",2439,2293,146
32,029,"Storey County, NV",1891,1770,121
32,031,"Washoe County, NV",227991,216417,11574
32,033,"White Pine County, NV",4448,4238,210
32,510,"Carson City, NV",24529,23017,1512
33,001,"Belknap County, NH",31427,30536,891
33,003,"Carroll County, NH",23702,23003,699
33,005,"Cheshire County, NH",41458,40323,1135
33,007,"Coos County, NH",14662,14109,553
33,009,"Grafton County, NH",48813,47659,1154
33,011,"Hillsborough County, NH",232312,225276,7036
33,013,"Merrimack County, NH",82037,79943,2094
33,015,"Rockingham County, NH",181925,176410,5515
33,017,"Strafford County, NH",72514,70666,1848
33,019,"Sullivan County, NH",23626,23075,551
34,001,"Atlantic County, NJ",122855,113793,9062
34,003,"Bergen County, NJ",480916,460970,19946
34,005,"Burlington County, NJ",230410,220184,10226
34,007,"Camden County, NJ",252853,239027,13826
34,009,"Cape May County, NJ",46780,42204,4576
34,011,"Cumberland County, NJ",66489,61546,4943
34,013,"Essex County, NJ",369898,347867,22031
34,015,"Gloucester County, NJ",149058,141551,7507
34,017,"Hudson County, NJ",360730,344004,16726
34,019,"Hunterdon County, NJ",64574,62163,2411
34,021,"Mercer County, NJ",198847,190295,8552
34,023,"Middlesex County, NJ",437739,418503,19236
34,025,"Monmouth County, NJ",327641,313165,14476
34,027,"Morris County, NJ",259361,249294,10067
34,029,"Ocean County, NJ",268831,254901,13930
34,031,"Passaic County, NJ",244584,229603,14981
34,033,"Salem County, NJ",30073,28162,1911
34,035,"Somerset County, NJ",172875,165923,6952
34,037,"Sussex County, NJ",75182,71667,3515
34,039,"Union County, NJ",276619,262443,14176
34,041,"Warren County, NJ",56509,53937,2572
35,001,"Bernalillo County, NM",329282,309914,19368
35,003,"Catron County, NM",1214,1115,99
35,005,"Chaves County, NM",28257,26338,1919
35,006,"Cibola County, NM",9379,8600,779
35,007,"Colfax County, NM",5874,5517,357
35,009,"Curry County, NM",22136,21004,1132
35,011,"De Baca County, NM",839,799,40
35,013,"Dona Ana County, NM",96370,89390,6980
35,015,"Eddy County, NM",28918,27013,1905
35,017,"Grant County, NM",12559,11740,819
35,019,"Guadalupe County, NM",1705,1593,112
35,021,"Harding County, NM",280,260,20
35,023,"Hidalgo County, NM",2219,2095,124
35,025,"Lea County, NM",27967,25359,2608
35,027,"Lincoln County, NM",8708,8184,524
35,028,"Los Alamos County, NM",8862,8482,380
35,029,"Luna County, NM",10870,9283,1587
35,031,"McKinley County, NM",24587,22260,2327
35,033,"Mora County, NM",2256,2057,199
35,035,"Otero County, NM",25674,24101,1573
35,037,"Quay County, NM",3235,3013,222
35,039,"Rio Arriba County, NM",16892,15617,1275
35,041,"Roosevelt County, NM",8130,7661,469
35,043,"Sandoval County, NM",64607,60300,4307
35,045,"San Juan County, NM",54678,49824,4854
35,047,"San Miguel County, NM",11179,10310,869
35,049,"Santa Fe County, NM",74060,70098,3962
35,051,"Sierra County, NM",4094,3745,349
35,053,"Socorro County, NM",6733,6233,500
35,055,"Taos County, NM",15062,13780,1282
35,057,"Torrance County, NM",5554,5042,512
35,059,"Union County, NM",1909,1831,78
35,061,"Valencia County, NM",30156,27958,2198
36,001,"Albany County, NY",158526,151974,6552
36,003,"Allegany County, NY",20070,18781,1289
36,005,"Bronx County, NY",603006,560468,42538
36,007,"Broome County, NY",85916,81177,4739
36,009,"Cattaraugus County, NY",34879,32760,2119
36,011,"Cayuga County, NY",36716,34828,1888
36,013,"Chautauqua County, NY",56159,52844,3315
36,015,"Chemung County, NY",36232,34123,2109
36,017,"Chenango County, NY",22844,21668,1176
36,019,"Clinton County, NY",35822,33869,1953
36,021,"Columbia County, NY",31473,30294,1179
36,023,"Cortland County, NY",22999,21667,1332
36,025,"Delaware County, NY",19234,18154,1080
36,027,"Dutchess County, NY",143108,137045,6063
36,029,"Erie County, NY",445373,423060,22313
36,031,"Essex County, NY",17248,16311,937
36,033,"Franklin County, NY",19804,18662,1142
36,035,"Fulton County, NY",23238,21886,1352
36,037,"Genesee County, NY",29744,28357,1387
36,039,"Greene County, NY",20575,19517,1058
36,041,"Hamilton County, NY",2366,2210,156
36,043,"Herkimer County, NY",28187,26620,1567
36,045,"Jefferson County, NY",45691,42795,2896
36,047,"Kings County, NY",1206229,1142605,63624
36,049,"Lewis County, NY",11752,10949,803
36,051,"Livingston County, NY",31052,29491,1561
36,053,"Madison County, NY",32717,30966,1751
36,055,"Monroe County, NY",363421,346044,17377
36,057,"Montgomery County, NY",22321,21022,1299
36,059,"Nassau County, NY",700139,672300,27839
36,061,"New York County, NY",908259,867324,40935
36,063,"Niagara County, NY",100281,94345,5936
36,065,"Oneida County, NY",101706,96689,5017
36,067,"Onondaga County, NY",221252,211093,10159
36,069,"Ontario County, NY",55084,52667,2417
36,071,"Orange County, NY",178963,171096,7867
36,073,"Orleans County, NY",17760,16727,1033
36,075,"Oswego County, NY",53335,49835,3500
36,077,"Otsego County, NY",28215,26806,1409
36,079,"Putnam County, NY",50700,48646,2054
36,081,"Queens County, NY",1150751,1099048,51703
36,083,"Rensselaer County, NY",81585,78036,3549
36,085,"Richmond County, NY",219313,207941,11372
36,087,"Rockland County, NY",152561,146064,6497
36,089,"St. Lawrence County, NY",43387,40479,2908
36,091,"Saratoga County, NY",117493,112934,4559
36,093,"Schenectady County, NY",75807,72465,3342
36,095,"Schoharie County, NY",14731,13917,814
36,097,"Schuyler County, NY",8281,7775,506
36,099,"Seneca County, NY",15494,14743,751
36,101,"Steuben County, NY",43187,40628,2559
36,103,"Suffolk County, NY",774238,739954,34284
36,105,"Sullivan County, NY",34048,32392,1656
36,107,"Tioga County, NY",23027,21824,1203
36,109,"Tompkins County, NY",50377,48245,2132
36,111,"Ulster County, NY",88189,84222,3967
36,113,"Warren County, NY",32003,30292,1711
36,115,"Washington County, NY",28352,27012,1340
36,117,"Wayne County, NY",44010,41779,2231
36,119,"Westchester County, NY",477963,457115,20848
36,121,"Wyoming County, NY",18115,17133,982
36,123,"Yates County, NY",11720,11194,526
37,001,"Alamance County, NC",78694,74964,3730
37,003,"Alexander County, NC",17778,17022,756
37,005,"Alleghany County, NC",4413,4170,243
37,007,"Anson County, NC",10627,10011,616
37,009,"Ashe County, NC",12468,11870,598
37,011,"Avery County, NC",7551,7171,380
37,013,"Beaufort County, NC",20244,19091,1153
37,015,"Bertie County, NC",8411,7854,557
37,017,"Bladen County, NC",14524,13519,1005
37,019,"Brunswick County, NC",49551,46354,3197
37,021,"Buncombe County, NC",133951,128768,5183
37,023,"Burke County, NC",39733,37798,1935
37,025,"Cabarrus County, NC",100864,96254,4610
37,027,"Caldwell County, NC",35786,33928,1858
37,029,"Camden County, NC",4643,4404,239
37,031,"Carteret County, NC",31473,29850,1623
37,033,"Caswell County, NC",9661,9135,526
37,035,"Catawba County, NC",76648,73016,3632
37,037,"Chatham County, NC",34416,32957,1459
37,039,"Cherokee County, NC",11111,10479,632
37,041,"Chowan County, NC",5585,5227,358
37,043,"Clay County, NC",4039,3818,221
37,045,"Cleveland County, NC",46669,44114,2555
37,047,"Columbus County, NC",22528,21081,1447
37,049,"Craven County, NC",41628,39448,2180
37,051,"Cumberland County, NC",126947,118818,8129
37,053,"Currituck County, NC",13111,12446,665
37,055,"Dare County, NC",19939,18593,1346
37,057,"Davidson County, NC",79258,75444,3814
37,059,"Davie County, NC",20107,19202,905
37,061,"Duplin County, NC",26422,25012,1410
37,063,"Durham County, NC",161608,154321,7287
37,065,"Edgecombe County, NC",22353,20411,1942
37,067,"Forsyth County, NC",182081,173210,8871
37,069,"Franklin County, NC",29255,27725,1530
37,071,"Gaston County, NC",105324,99700,5624
37,073,"Gates County, NC",5175,4909,266
37,075,"Graham County, NC",3092,2819,273
37,077,"Granville County, NC",29191,27928,1263
37,079,"Greene County, NC",9496,8992,504
37,081,"Guilford County, NC",257680,244175,13505
37,083,"Halifax County, NC",20621,18985,1636
37,085,"Harnett County, NC",51302,48328,2974
37,087,"Haywood County, NC",28396,27104,1292
37,089,"Henderson County, NC",52134,49909,2225
37,091,"Hertford County, NC",9287,8676,611
37,093,"Hoke County, NC",19855,18545,1310
37,095,"Hyde County, NC",2103,1904,199
37,097,"Iredell County, NC",84300,80244,4056
37,099,"Jackson County, NC",18773,17751,1022
37,101,"Johnston County, NC",91306,87026,4280
37,103,"Jones County, NC",4501,4263,238
37,105,"Lee County, NC",26150,24611,1539
37,107,"Lenoir County, NC",27566,25947,1619
37,109,"Lincoln County, NC",40966,39033,1933
37,111,"McDowell County, NC",20950,19943,1007
37,113,"Macon County, NC",15171,14353,818
37,115,"Madison County, NC",9671,9200,471
37,117,"Martin County, NC",9784,9122,662
37,119,"Mecklenburg County, NC",581630,554067,27563
37,121,"Mitchell County, NC",6169,5791,378
37,123,"Montgomery County, NC",11664,11061,603
37,125,"Moore County, NC",39389,37411,1978
37,127,"Nash County, NC",43792,40909,2883
37,129,"New Hanover County, NC",115690,110226,5464
37,131,"Northampton County, NC",7791,7225,566
37,133,"Onslow County, NC",63519,60018,3501
37,135,"Orange County, NC",74699,71532,3167
37,137,"Pamlico County, NC",5392,5107,285
37,139,"Pasquotank County, NC",17344,16252,1092
37,141,"Pender County, NC",26769,25350,1419
37,143,"Perquimans County, NC",5086,4758,328
37,145,"Person County, NC",17980,16993,987
37,147,"Pitt County, NC",87935,83032,4903
37,149,"Polk County, NC",8798,8389,409
37,151,"Randolph County, NC",66681,63396,3285
37,153,"Richmond County, NC",16739,15579,1160
37,155,"Robeson County, NC",50401,46394,4007
37,157,"Rockingham County, NC",40727,38423,2304
37,159,"Rowan County, NC",64035,60466,3569
37,161,"Rutherford County, NC",24733,23078,1655
37,163,"Sampson County, NC",29423,27817,1606
37,165,"Scotland County, NC",11601,10540,1061
37,167,"Stanly County, NC",29195,27841,1354
37,169,"Stokes County, NC",21805,20762,1043
37,171,"Surry County, NC",33418,31820,1598
37,173,"Swain County, NC",7096,6663,433
37,175,"Transylvania County, NC",13915,13237,678
37,177,"Tyrrell County, NC",1525,1396,129
37,179,"Union County, NC",115411,110320,5091
37,181,"Vance County, NC",17949,16663,1286
37,183,"Wake County, NC",554963,531092,23871
37,185,"Warren County, NC",7120,6600,520
37,187,"Washington County, NC",4850,4490,360
37,189,"Watauga County, NC",27861,26608,1253
37,191,"Wayne County, NC",53390,50274,3116
37,193,"Wilkes County, NC",30109,28665,1444
37,195,"Wilson County, NC",36377,33408,2969
37,197,"Yadkin County, NC",17557,16786,771
37,199,"Yancey County, NC",7455,7070,385
38,001,"Adams County, ND",1131,1102,29
38,003,"Barnes County, ND",5609,5430,179
38,005,"Benson County, ND",2429,2332,97
38,007,"Billings County, ND",437,424,13
38,009,"Bottineau County, ND",3222,3072,150
38,011,"Bowman County, ND",1832,1792,40
38,013,"Burke County, ND",1143,1091,52
38,015,"Burleigh County, ND",50517,49212,1305
38,017,"Cass County, ND",99994,97756,2238
38,019,"Cavalier County, ND",2111,2055,56
38,021,"Dickey County, ND",2541,2492,49
38,023,"Divide County, ND",1680,1636,44
38,025,"Dunn County, ND",3241,3139,102
38,027,"Eddy County, ND",1276,1221,55
38,029,"Emmons County, ND",1581,1512,69
38,031,"Foster County, ND",1682,1632,50
38,033,"Golden Valley County, ND",969,943,26
38,035,"Grand Forks County, ND",38733,37818,915
38,037,"Grant County, ND",1294,1255,39
38,039,"Griggs County, ND",1157,1124,33
38,041,"Hettinger County, ND",1536,1490,46
38,043,"Kidder County, ND",1373,1321,52
38,045,"LaMoure County, ND",2310,2255,55
38,047,"Logan County, ND",957,924,33
38,049,"McHenry County, ND",3369,3204,165
38,051,"McIntosh County, ND",1238,1200,38
38,053,"McKenzie County, ND",7930,7631,299
38,055,"McLean County, ND",5058,4882,176
38,057,"Mercer County, ND",4643,4439,204
38,059,"Morton County, ND",16758,16212,546
38,061,"Mountrail County, ND",7117,6904,213
38,063,"Nelson County, ND",1531,1479,52
38,065,"Oliver County, ND",896,847,49
38,067,"Pembina County, ND",3652,3469,183
38,069,"Pierce County, ND",1894,1819,75
38,071,"Ramsey County, ND",6133,5958,175
38,073,"Ransom County, ND",2833,2769,64
38,075,"Renville County, ND",1306,1255,51
38,077,"Richland County, ND",8884,8640,244
38,079,"Rolette County, ND",4977,4437,540
38,081,"Sargent County, ND",2327,2282,45
38,083,"Sheridan County, ND",734,693,41
38,085,"Sioux County, ND",1336,1277,59
38,087,"Slope County, ND",435,424,11
38,089,"Stark County, ND",18048,17341,707
38,091,"Steele County, ND",1072,1049,23
38,093,"Stutsman County, ND",11055,10782,273
38,095,"Towner County, ND",1328,1299,29
38,097,"Traill County, ND",4589,4461,128
38,099,"Walsh County, ND",5649,5435,214
38,101,"Ward County, ND",33466,32086,1380
38,103,"Wells County, ND",2185,2101,84
38,105,"Williams County, ND",22585,21599,986
39,001,"Adams County, OH",10987,10156,831
39,003,"Allen County, OH",48450,46006,2444
39,005,"Ashland County, OH",26365,25018,1347
39,007,"Ashtabula County, OH",44399,41673,2726
39,009,"Athens County, OH",28129,26318,1811
39,011,"Auglaize County, OH",24716,23789,927
39,013,"Belmont County, OH",31137,28798,2339
39,015,"Brown County, OH",19569,18429,1140
39,017,"Butler County, OH",190182,181562,8620
39,019,"Carroll County, OH",13491,12562,929
39,021,"Champaign County, OH",19958,19055,903
39,023,"Clark County, OH",63827,60463,3364
39,025,"Clermont County, OH",104313,99654,4659
39,027,"Clinton County, OH",17238,16228,1010
39,029,"Columbiana County, OH",48577,45310,3267
39,031,"Coshocton County, OH",15054,13980,1074
39,033,"Crawford County, OH",19246,18079,1167
39,035,"Cuyahoga County, OH",612160,578168,33992
39,037,"Darke County, OH",26477,25380,1097
39,039,"Defiance County, OH",18453,17536,917
39,041,"Delaware County, OH",105264,101438,3826
39,043,"Erie County, OH",37574,35494,2080
39,045,"Fairfield County, OH",76253,72940,3313
39,047,"Fayette County, OH",14545,13896,649
39,049,"Franklin County, OH",669446,641672,27774
39,051,"Fulton County, OH",22766,21700,1066
39,053,"Gallia County, OH",12176,11340,836
39,055,"Geauga County, OH",49049,46852,2197
39,057,"Greene County, OH",81414,77853,3561
39,059,"Guernsey County, OH",18968,17613,1355
39,061,"Hamilton County, OH",406542,388426,18116
39,063,"Hancock County, OH",41625,40080,1545
39,065,"Hardin County, OH",14434,13709,725
39,067,"Harrison County, OH",6998,6460,538
39,069,"Henry County, OH",13660,12924,736
39,071,"Highland County, OH",16998,15913,1085
39,073,"Hocking County, OH",13063,12329,734
39,075,"Holmes County, OH",21073,20309,764
39,077,"Huron County, OH",28231,26380,1851
39,079,"Jackson County, OH",12853,11837,1016
39,081,"Jefferson County, OH",29024,26583,2441
39,083,"Knox County, OH",31354,29894,1460
39,085,"Lake County, OH",124566,118449,6117
39,087,"Lawrence County, OH",24851,23223,1628
39,089,"Licking County, OH",88594,84685,3909
39,091,"Logan County, OH",23413,22426,987
39,093,"Lorain County, OH",152264,143118,9146
39,095,"Lucas County, OH",211249,200233,11016
39,097,"Madison County, OH",20417,19608,809
39,099,"Mahoning County, OH",106380,99542,6838
39,101,"Marion County, OH",27849,26425,1424
39,103,"Medina County, OH",95889,91657,4232
39,105,"Meigs County, OH",8990,8218,772
39,107,"Mercer County, OH",23516,22743,773
39,109,"Miami County, OH",53220,50887,2333
39,111,"Monroe County, OH",5344,4745,599
39,113,"Montgomery County, OH",251039,238575,12464
39,115,"Morgan County, OH",6780,6214,566
39,117,"Morrow County, OH",16834,15978,856
39,119,"Muskingum County, OH",39897,37474,2423
39,121,"Noble County, OH",4913,4481,432
39,123,"Ottawa County, OH",21118,19744,1374
39,125,"Paulding County, OH",8910,8498,412
39,127,"Perry County, OH",15954,14929,1025
39,129,"Pickaway County, OH",26309,25028,1281
39,131,"Pike County, OH",10851,10031,820
39,133,"Portage County, OH",87472,83048,4424
39,135,"Preble County, OH",21103,20090,1013
39,137,"Putnam County, OH",18975,18275,700
39,139,"Richland County, OH",53626,50633,2993
39,141,"Ross County, OH",33973,32087,1886
39,143,"Sandusky County, OH",31149,29669,1480
39,145,"Scioto County, OH",29999,27662,2337
39,147,"Seneca County, OH",27259,25914,1345
39,149,"Shelby County, OH",24167,23158,1009
39,151,"Stark County, OH",187210,176932,10278
39,153,"Summit County, OH",273479,259430,14049
39,155,"Trumbull County, OH",90798,84612,6186
39,157,"Tuscarawas County, OH",45200,42585,2615
39,159,"Union County, OH",27903,26830,1073
39,161,"Van Wert County, OH",14361,13777,584
39,163,"Vinton County, OH",5476,5088,388
39,165,"Warren County, OH",115051,110242,4809
39,167,"Washington County, OH",27890,25931,1959
39,169,"Wayne County, OH",61460,58995,2465
39,171,"Williams County, OH",19100,18232,868
39,173,"Wood County, OH",70927,67946,2981
39,175,"Wyandot County, OH",12724,12249,475
40,001,"Adair County, OK",8141,7683,458
40,003,"Alfalfa County, OK",2965,2870,95
40,005,"Atoka County, OK",5052,4731,321
40,007,"Beaver County, OK",2885,2798,87
40,009,"Beckham County, OK",11011,10246,765
40,011,"Blaine County, OK",4388,4232,156
40,013,"Bryan County, OK",19490,18680,810
40,015,"Caddo County, OK",11908,11298,610
40,017,"Canadian County, OK",69350,66683,2667
40,019,"Carter County, OK",22690,21557,1133
40,021,"Cherokee County, OK",19259,18237,1022
40,023,"Choctaw County, OK",5742,5319,423
40,025,"Cimarron County, OK",1416,1382,34
40,027,"Cleveland County, OK",139036,133913,5123
40,029,"Coal County, OK",2317,2153,164
40,031,"Comanche County, OK",49391,47196,2195
40,033,"Cotton County, OK",2887,2753,134
40,035,"Craig County, OK",6245,5954,291
40,037,"Creek County, OK",31452,29687,1765
40,039,"Custer County, OK",15181,14514,667
40,041,"Delaware County, OK",17947,17100,847
40,043,"Dewey County, OK",2673,2568,105
40,045,"Ellis County, OK",2254,2171,83
40,047,"Garfield County, OK",28969,27748,1221
40,049,"Garvin County, OK",12697,12042,655
40,051,"Grady County, OK",26059,24810,1249
40,053,"Grant County, OK",3003,2910,93
40,055,"Greer County, OK",2186,2030,156
40,057,"Harmon County, OK",1292,1244,48
40,059,"Harper County, OK",1908,1838,70
40,061,"Haskell County, OK",4493,4134,359
40,063,"Hughes County, OK",5503,5117,386
40,065,"Jackson County, OK",10991,10526,465
40,067,"Jefferson County, OK",2705,2518,187
40,069,"Johnston County, OK",4368,4120,248
40,071,"Kay County, OK",18913,17761,1152
40,073,"Kingfisher County, OK",8444,8174,270
40,075,"Kiowa County, OK",4104,3893,211
40,077,"Latimer County, OK",3716,3406,310
40,079,"Le Flore County, OK",19720,18405,1315
40,081,"Lincoln County, OK",15857,15044,813
40,083,"Logan County, OK",21559,20717,842
40,085,"Love County, OK",6568,6368,200
40,087,"McClain County, OK",18944,18192,752
40,089,"McCurtain County, OK",14780,13760,1020
40,091,"McIntosh County, OK",7042,6435,607
40,093,"Major County, OK",3991,3832,159
40,095,"Marshall County, OK",6607,6285,322
40,097,"Mayes County, OK",19418,18464,954
40,099,"Murray County, OK",6338,6062,276
40,101,"Muskogee County, OK",29588,28033,1555
40,103,"Noble County, OK",5756,5560,196
40,105,"Nowata County, OK",4679,4404,275
40,107,"Okfuskee County, OK",4545,4278,267
40,109,"Oklahoma County, OK",374767,359263,15504
40,111,"Okmulgee County, OK",16123,15005,1118
40,113,"Osage County, OK",21040,19871,1169
40,115,"Ottawa County, OK",14450,13749,701
40,117,"Pawnee County, OK",7478,6999,479
40,119,"Payne County, OK",38882,37488,1394
40,121,"Pittsburg County, OK",17604,16561,1043
40,123,"Pontotoc County, OK",18442,17717,725
40,125,"Pottawatomie County, OK",33026,31553,1473
40,127,"Pushmataha County, OK",4866,4523,343
40,129,"Roger Mills County, OK",1809,1719,90
40,131,"Rogers County, OK",44828,42659,2169
40,133,"Seminole County, OK",9424,8795,629
40,135,"Sequoyah County, OK",16815,15799,1016
40,137,"Stephens County, OK",18974,17232,1742
40,139,"Texas County, OK",9396,9089,307
40,141,"Tillman County, OK",3308,3167,141
40,143,"Tulsa County, OK",317900,303589,14311
40,145,"Wagoner County, OK",36576,34892,1684
40,147,"Washington County, OK",23906,22779,1127
40,149,"Washita County, OK",5311,4956,355
40,151,"Woods County, OK",5216,5055,161
40,153,"Woodward County, OK",9502,8933,569
41,001,"Baker County, OR",6933,6504,429
41,003,"Benton County, OR",46695,44891,1804
41,005,"Clackamas County, OR",212188,203105,9083
41,007,"Clatsop County, OR",18975,18097,878
41,009,"Columbia County, OR",23557,22143,1414
41,011,"Coos County, OR",26370,24713,1657
41,013,"Crook County, OR",9316,8682,634
41,015,"Curry County, OR",9019,8421,598
41,017,"Deschutes County, OR",89650,85369,4281
41,019,"Douglas County, OR",45583,42770,2813
41,021,"Gilliam County, OR",836,787,49
41,023,"Grant County, OR",3098,2866,232
41,025,"Harney County, OR",3413,3204,209
41,027,"Hood River County, OR",13877,13312,565
41,029,"Jackson County, OR",101140,95428,5712
41,031,"Jefferson County, OR",9833,9195,638
41,033,"Josephine County, OR",34195,32019,2176
41,035,"Klamath County, OR",29144,27206,1938
41,037,"Lake County, OR",3443,3228,215
41,039,"Lane County, OR",178047,169145,8902
41,041,"Lincoln County, OR",20843,19695,1148
41,043,"Linn County, OR",56682,53505,3177
41,045,"Malheur County, OR",12445,11771,674
41,047,"Marion County, OR",157013,149200,7813
41,049,"Morrow County, OR",5753,5478,275
41,051,"Multnomah County, OR",442861,424464,18397
41,053,"Polk County, OR",38236,36337,1899
41,055,"Sherman County, OR",892,852,40
41,057,"Tillamook County, OR",11612,11051,561
41,059,"Umatilla County, OR",35921,34040,1881
41,061,"Union County, OR",11944,11252,692
41,063,"Wallowa County, OR",3305,3087,218
41,065,"Wasco County, OR",13655,13011,644
41,067,"Washington County, OR",312711,300084,12627
41,069,"Wheeler County, OR",684,656,28
41,071,"Yamhill County, OR",53067,50668,2399
42,001,"Adams County, PA",55472,53294,2178
42,003,"Allegheny County, PA",648489,615242,33247
42,005,"Armstrong County, PA",33133,30674,2459
42,007,"Beaver County, PA",85443,80207,5236
42,009,"Bedford County, PA",24082,22687,1395
42,011,"Berks County, PA",213539,203031,10508
42,013,"Blair County, PA",60859,57677,3182
42,015,"Bradford County, PA",30214,28262,1952
42,017,"Bucks County, PA",341373,325784,15589
42,019,"Butler County, PA",98766,93817,4949
42,021,"Cambria County, PA",61532,57404,4128
42,023,"Cameron County, PA",2234,2072,162
42,025,"Carbon County, PA",31613,29747,1866
42,027,"Centre County, PA",79058,75796,3262
42,029,"Chester County, PA",280797,270039,10758
42,031,"Clarion County, PA",18053,16953,1100
42,033,"Clearfield County, PA",36354,33733,2621
42,035,"Clinton County, PA",18579,17278,1301
42,037,"Columbia County, PA",33950,32091,1859
42,039,"Crawford County, PA",40559,38150,2409
42,041,"Cumberland County, PA",130295,125064,5231
42,043,"Dauphin County, PA",142301,135593,6708
42,045,"Delaware County, PA",294655,280449,14206
42,047,"Elk County, PA",16356,15464,892
42,049,"Erie County, PA",133789,125178,8611
42,051,"Fayette County, PA",58506,53815,4691
42,053,"Forest County, PA",1893,1746,147
42,055,"Franklin County, PA",77607,73651,3956
42,057,"Fulton County, PA",7314,6857,457
42,059,"Greene County, PA",17318,15991,1327
42,061,"Huntingdon County, PA",19687,18326,1361
42,063,"Indiana County, PA",40217,37321,2896
42,065,"Jefferson County, PA",20730,19326,1404
42,067,"Juniata County, PA",12217,11570,647
42,069,"Lackawanna County, PA",107087,101105,5982
42,071,"Lancaster County, PA",278301,266858,11443
42,073,"Lawrence County, PA",41562,38799,2763
42,075,"Lebanon County, PA",70694,67561,3133
42,077,"Lehigh County, PA",189319,179314,10005
42,079,"Luzerne County, PA",159198,149291,9907
42,081,"Lycoming County, PA",58797,54941,3856
42,083,"McKean County, PA",18515,17303,1212
42,085,"Mercer County, PA",52607,49502,3105
42,087,"Mifflin County, PA",20836,19657,1179
42,089,"Monroe County, PA",82003,76939,5064
42,091,"Montgomery County, PA",448108,429780,18328
42,093,"Montour County, PA",9142,8757,385
42,095,"Northampton County, PA",159085,150961,8124
42,097,"Northumberland County, PA",44014,41296,2718
42,099,"Perry County, PA",24316,23206,1110
42,101,"Philadelphia County/city, PA",704284,657187,47097
42,103,"Pike County, PA",24968,23395,1573
42,105,"Potter County, PA",7390,6816,574
42,107,"Schuylkill County, PA",67661,63524,4137
42,109,"Snyder County, PA",20547,19598,949
42,111,"Somerset County, PA",34234,31799,2435
42,113,"Sullivan County, PA",2844,2642,202
42,115,"Susquehanna County, PA",20904,19729,1175
42,117,"Tioga County, PA",19892,18489,1403
42,119,"Union County, PA",19811,18874,937
42,121,"Venango County, PA",23742,22040,1702
42,123,"Warren County, PA",19804,18732,1072
42,125,"Washington County, PA",107411,100914,6497
42,127,"Wayne County, PA",22564,21282,1282
42,129,"Westmoreland County, PA",183064,172471,10593
42,131,"Wyoming County, PA",14127,13261,866
42,133,"York County, PA",235081,224336,10745
44,001,"Bristol County, RI",26132,24919,1213
44,003,"Kent County, RI",90719,86415,4304
44,005,"Newport County, RI",44231,42145,2086
44,007,"Providence County, RI",323196,305286,17910
44,009,"Washington County, RI",68954,65674,3280
45,001,"Abbeville County, SC",10252,9702,550
45,003,"Aiken County, SC",73907,70293,3614
45,005,"Allendale County, SC",2651,2429,222
45,007,"Anderson County, SC",88643,84665,3978
45,009,"Bamberg County, SC",5295,4827,468
45,011,"Barnwell County, SC",8043,7462,581
45,013,"Beaufort County, SC",72294,68914,3380
45,015,"Berkeley County, SC",96705,92384,4321
45,017,"Calhoun County, SC",6878,6462,416
45,019,"Charleston County, SC",201188,193146,8042
45,021,"Cherokee County, SC",23456,22085,1371
45,023,"Chester County, SC",13344,12404,940
45,025,"Chesterfield County, SC",21568,20516,1052
45,027,"Clarendon County, SC",12677,11849,828
45,029,"Colleton County, SC",16703,15788,915
45,031,"Darlington County, SC",29810,27993,1817
45,033,"Dillon County, SC",12643,11805,838
45,035,"Dorchester County, SC",72954,69685,3269
45,037,"Edgefield County, SC",10514,9931,583
45,039,"Fairfield County, SC",9962,9258,704
45,041,"Florence County, SC",65180,61817,3363
45,043,"Georgetown County, SC",24882,23225,1657
45,045,"Greenville County, SC",244829,234676,10153
45,047,"Greenwood County, SC",31252,29671,1581
45,049,"Hampton County, SC",8203,7734,469
45,051,"Horry County, SC",139740,131738,8002
45,053,"Jasper County, SC",11964,11454,510
45,055,"Kershaw County, SC",29157,27668,1489
45,057,"Lancaster County, SC",38222,36233,1989
45,059,"Laurens County, SC",29943,28417,1526
45,061,"Lee County, SC",6417,5972,445
45,063,"Lexington County, SC",147657,141777,5880
45,065,"McCormick County, SC",3383,3198,185
45,067,"Marion County, SC",12632,11553,1079
45,069,"Marlboro County, SC",9278,8514,764
45,071,"Newberry County, SC",19135,18303,832
45,073,"Oconee County, SC",34119,32396,1723
45,075,"Orangeburg County, SC",35474,32396,3078
45,077,"Pickens County, SC",56189,53455,2734
45,079,"Richland County, SC",199813,190406,9407
45,081,"Saluda County, SC",8870,8476,394
45,083,"Spartanburg County, SC",141957,135410,6547
45,085,"Sumter County, SC",44134,41595,2539
45,087,"Union County, SC",11431,10736,695
45,089,"Williamsburg County, SC",12431,11490,941
45,091,"York County, SC",130280,124395,5885
46,003,"Aurora County, SD",1528,1494,34
46,005,"Beadle County, SD",9459,9213,246
46,007,"Bennett County, SD",1129,1084,45
46,009,"Bon Homme County, SD",2960,2879,81
46,011,"Brookings County, SD",18983,18457,526
46,013,"Brown County, SD",21196,20623,573
46,015,"Brule County, SD",2484,2420,64
46,017,"Buffalo County, SD",730,669,61
46,019,"Butte County, SD",5073,4896,177
46,021,"Campbell County, SD",854,829,25
46,023,"Charles Mix County, SD",3908,3782,126
46,025,"Clark County, SD",1930,1854,76
46,027,"Clay County, SD",7023,6810,213
46,029,"Codington County, SD",15283,14808,475
46,031,"Corson County, SD",1461,1395,66
46,033,"Custer County, SD",4014,3852,162
46,035,"Davison County, SD",11294,11021,273
46,037,"Day County, SD",2873,2751,122
46,039,"Deuel County, SD",2251,2141,110
46,041,"Dewey County, SD",2266,2059,207
46,043,"Douglas County, SD",1680,1637,43
46,045,"Edmunds County, SD",2174,2123,51
46,047,"Fall River County, SD",3039,2905,134
46,049,"Faulk County, SD",1119,1089,30
46,051,"Grant County, SD",4480,4335,145
46,053,"Gregory County, SD",2086,2023,63
46,055,"Haakon County, SD",1111,1084,27
46,057,"Hamlin County, SD",3190,3082,108
46,059,"Hand County, SD",1841,1801,40
46,061,"Hanson County, SD",1778,1717,61
46,063,"Harding County, SD",765,743,22
46,065,"Hughes County, SD",10113,9872,241
46,067,"Hutchinson County, SD",3668,3574,94
46,069,"Hyde County, SD",702,683,19
46,071,"Jackson County, SD",1311,1256,55
46,073,"Jerauld County, SD",1077,1050,27
46,075,"Jones County, SD",572,558,14
46,077,"Kingsbury County, SD",2754,2681,73
46,079,"Lake County, SD",6491,6268,223
46,081,"Lawrence County, SD",13129,12692,437
46,083,"Lincoln County, SD",31596,30908,688
46,085,"Lyman County, SD",1784,1700,84
46,087,"McCook County, SD",3149,3070,79
46,089,"McPherson County, SD",1094,1056,38
46,091,"Marshall County, SD",2473,2377,96
46,093,"Meade County, SD",13746,13310,436
46,095,"Mellette County, SD",774,741,33
46,097,"Miner County, SD",1206,1174,32
46,099,"Minnehaha County, SD",108249,105446,2803
46,101,"Moody County, SD",3970,3823,147
46,102,"Oglala Lakota County, SD",3634,3239,395
46,103,"Pennington County, SD",54987,53277,1710
46,105,"Perkins County, SD",1585,1539,46
46,107,"Potter County, SD",1163,1131,32
46,109,"Roberts County, SD",4865,4663,202
46,111,"Sanborn County, SD",1215,1179,36
46,115,"Spink County, SD",3302,3199,103
46,117,"Stanley County, SD",1879,1834,45
46,119,"Sully County, SD",863,843,20
46,121,"Todd County, SD",3077,2876,201
46,123,"Tripp County, SD",3078,3009,69
46,125,"Turner County, SD",4700,4568,132
46,127,"Union County, SD",8090,7836,254
46,129,"Walworth County, SD",2254,2137,117
46,135,"Yankton County, SD",11643,11341,302
46,137,"Ziebach County, SD",981,936,45
47,001,"Anderson County, TN",33693,32045,1648
47,003,"Bedford County, TN",19835,18846,989
47,005,"Benton County, TN",6744,6262,482
47,007,"Bledsoe County, TN",4325,4023,302
47,009,"Blount County, TN",60872,58202,2670
47,011,"Bradley County, TN",50153,47911,2242
47,013,"Campbell County, TN",14743,13720,1023
47,015,"Cannon County, TN",6024,5744,280
47,017,"Carroll County, TN",12031,11219,812
47,019,"Carter County, TN",23685,22342,1343
47,021,"Cheatham County, TN",20271,19462,809
47,023,"Chester County, TN",8450,8028,422
47,025,"Claiborne County, TN",12706,11913,793
47,027,"Clay County, TN",3044,2844,200
47,029,"Cocke County, TN",14460,13543,917
47,031,"Coffee County, TN",24470,23310,1160
47,033,"Crockett County, TN",6890,6528,362
47,035,"Cumberland County, TN",23576,22174,1402
47,037,"Davidson County, TN",374155,360601,13554
47,039,"Decatur County, TN",4663,4341,322
47,041,"DeKalb County, TN",7553,7131,422
47,043,"Dickson County, TN",24797,23714,1083
47,045,"Dyer County, TN",16376,15357,1019
47,047,"Fayette County, TN",18294,17369,925
47,049,"Fentress County, TN",7111,6671,440
47,051,"Franklin County, TN",19851,18884,967
47,053,"Gibson County, TN",21250,20001,1249
47,055,"Giles County, TN",15282,14665,617
47,057,"Grainger County, TN",9292,8786,506
47,059,"Greene County, TN",30893,29202,1691
47,061,"Grundy County, TN",4793,4482,311
47,063,"Hamblen County, TN",26867,25489,1378
47,065,"Hamilton County, TN",172011,164062,7949
47,067,"Hancock County, TN",2035,1873,162
47,069,"Hardeman County, TN",9201,8633,568
47,071,"Hardin County, TN",10211,9599,612
47,073,"Hawkins County, TN",23723,22439,1284
47,075,"Haywood County, TN",7681,7181,500
47,077,"Henderson County, TN",11995,11172,823
47,079,"Henry County, TN",13932,13109,823
47,081,"Hickman County, TN",10442,9957,485
47,083,"Houston County, TN",3200,2959,241
47,085,"Humphreys County, TN",8647,8126,521
47,087,"Jackson County, TN",4495,4180,315
47,089,"Jefferson County, TN",23629,22377,1252
47,091,"Johnson County, TN",7546,7182,364
47,093,"Knox County, TN",233831,224458,9373
47,095,"Lake County, TN",1917,1767,150
47,097,"Lauderdale County, TN",9442,8710,732
47,099,"Lawrence County, TN",17806,16776,1030
47,101,"Lewis County, TN",4890,4599,291
47,103,"Lincoln County, TN",15974,15318,656
47,105,"Loudon County, TN",22295,21250,1045
47,107,"McMinn County, TN",22776,21535,1241
47,109,"McNairy County, TN",8772,8154,618
47,111,"Macon County, TN",10243,9795,448
47,113,"Madison County, TN",47829,45493,2336
47,115,"Marion County, TN",11929,11176,753
47,117,"Marshall County, TN",15083,14385,698
47,119,"Maury County, TN",44115,42327,1788
47,121,"Meigs County, TN",4901,4565,336
47,123,"Monroe County, TN",19417,18388,1029
47,125,"Montgomery County, TN",80018,75931,4087
47,127,"Moore County, TN",3387,3259,128
47,129,"Morgan County, TN",7809,7304,505
47,131,"Obion County, TN",12580,11691,889
47,133,"Overton County, TN",9222,8727,495
47,135,"Perry County, TN",3192,2989,203
47,137,"Pickett County, TN",2328,2173,155
47,139,"Polk County, TN",7394,6970,424
47,141,"Putnam County, TN",33282,31644,1638
47,143,"Rhea County, TN",13485,12523,962
47,145,"Roane County, TN",22878,21599,1279
47,147,"Robertson County, TN",34780,33328,1452
47,149,"Rutherford County, TN",163741,157663,6078
47,151,"Scott County, TN",8028,7432,596
47,153,"Sequatchie County, TN",5926,5579,347
47,155,"Sevier County, TN",51239,48696,2543
47,157,"Shelby County, TN",434502,411215,23287
47,159,"Smith County, TN",8687,8288,399
47,161,"Stewart County, TN",5171,4819,352
47,163,"Sullivan County, TN",69815,66193,3622
47,165,"Sumner County, TN",92394,88792,3602
47,167,"Tipton County, TN",27529,25958,1571
47,169,"Trousdale County, TN",3849,3662,187
47,171,"Unicoi County, TN",7017,6517,500
47,173,"Union County, TN",7285,6862,423
47,175,"Van Buren County, TN",2038,1912,126
47,177,"Warren County, TN",17685,16832,853
47,179,"Washington County, TN",58782,55964,2818
47,181,"Wayne County, TN",6093,5691,402
47,183,"Weakley County, TN",15875,14944,931
47,185,"White County, TN",11770,11182,588
47,187,"Williamson County, TN",113631,109736,3895
47,189,"Wilson County, TN",67876,65252,2624
48,001,"Anderson County, TX",23518,22499,1019
48,003,"Andrews County, TX",8693,8282,411
48,005,"Angelina County, TX",37081,34888,2193
48,007,"Aransas County, TX",10241,9669,572
48,009,"Archer County, TX",4091,3914,177
48,011,"Armstrong County, TX",934,908,26
48,013,"Atascosa County, TX",21031,19906,1125
48,015,"Austin County, TX",14036,13287,749
48,017,"Bailey County, TX",2719,2600,119
48,019,"Bandera County, TX",9507,9116,391
48,021,"Bastrop County, TX",39046,37583,1463
48,023,"Baylor County, TX",1606,1548,58
48,025,"Bee County, TX",10314,9537,777
48,027,"Bell County, TX",139561,133264,6297
48,029,"Bexar County, TX",905846,871855,33991
48,031,"Blanco County, TX",5937,5753,184
48,033,"Borden County, TX",366,353,13
48,035,"Bosque County, TX",8191,7838,353
48,037,"Bowie County, TX",39643,37775,1868
48,039,"Brazoria County, TX",169940,161111,8829
48,041,"Brazos County, TX",111338,107481,3857
48,043,"Brewster County, TX",3963,3814,149
48,045,"Briscoe County, TX",548,524,24
48,047,"Brooks County, TX",2441,2152,289
48,049,"Brown County, TX",16177,15473,704
48,051,"Burleson County, TX",7880,7513,367
48,053,"Burnet County, TX",22004,21241,763
48,055,"Caldwell County, TX",17952,17173,779
48,057,"Calhoun County, TX",10780,10178,602
48,059,"Callahan County, TX",5808,5560,248
48,061,"Cameron County, TX",166111,154169,11942
48,063,"Camp County, TX",5064,4717,347
48,065,"Carson County, TX",3098,2997,101
48,067,"Cass County, TX",12276,11391,885
48,069,"Castro County, TX",3497,3389,108
48,071,"Chambers County, TX",18221,17110,1111
48,073,"Cherokee County, TX",21208,20128,1080
48,075,"Childress County, TX",2961,2872,89
48,077,"Clay County, TX",4797,4587,210
48,079,"Cochran County, TX",1174,1115,59
48,081,"Coke County, TX",1422,1363,59
48,083,"Coleman County, TX",3067,2888,179
48,085,"Collin County, TX",513225,495061,18164
48,087,"Collingsworth County, TX",1216,1174,42
48,089,"Colorado County, TX",9798,9336,462
48,091,"Comal County, TX",65520,63146,2374
48,093,"Comanche County, TX",5360,5129,231
48,095,"Concho County, TX",1332,1287,45
48,097,"Cooke County, TX",18923,18171,752
48,099,"Coryell County, TX",24428,23285,1143
48,101,"Cottle County, TX",525,498,27
48,103,"Crane County, TX",1706,1560,146
48,105,"Crockett County, TX",1737,1606,131
48,107,"Crosby County, TX",2623,2508,115
48,109,"Culberson County, TX",1000,959,41
48,111,"Dallam County, TX",4001,3912,89
48,113,"Dallas County, TX",1299134,1246814,52320
48,115,"Dawson County, TX",4643,4409,234
48,117,"Deaf Smith County, TX",8614,8344,270
48,119,"Delta County, TX",2607,2508,99
48,121,"Denton County, TX",452147,436615,15532
48,123,"DeWitt County, TX",9502,8983,519
48,125,"Dickens County, TX",692,658,34
48,127,"Dimmit County, TX",6242,5796,446
48,129,"Donley County, TX",1557,1494,63
48,131,"Duval County, TX",4887,4352,535
48,133,"Eastland County, TX",7424,7019,405
48,135,"Ector County, TX",76245,71389,4856
48,137,"Edwards County, TX",867,827,40
48,139,"Ellis County, TX",85025,81835,3190
48,141,"El Paso County, TX",349935,332601,17334
48,143,"Erath County, TX",20240,19418,822
48,145,"Falls County, TX",6613,6321,292
48,147,"Fannin County, TX",15774,15179,595
48,149,"Fayette County, TX",12496,12039,457
48,151,"Fisher County, TX",1760,1684,76
48,153,"Floyd County, TX",2738,2600,138
48,155,"Foard County, TX",540,520,20
48,157,"Fort Bend County, TX",367050,348684,18366
48,159,"Franklin County, TX",4512,4290,222
48,161,"Freestone County, TX",6872,6412,460
48,163,"Frio County, TX",8783,8355,428
48,165,"Gaines County, TX",9187,8844,343
48,167,"Galveston County, TX",160171,151625,8546
48,169,"Garza County, TX",2131,2048,83
48,171,"Gillespie County, TX",13001,12631,370
48,173,"Glasscock County, TX",749,720,29
48,175,"Goliad County, TX",3320,3127,193
48,177,"Gonzales County, TX",9574,9168,406
48,179,"Gray County, TX",8489,7903,586
48,181,"Grayson County, TX",61232,58868,2364
48,183,"Gregg County, TX",58383,54826,3557
48,185,"Grimes County, TX",11058,10326,732
48,187,"Guadalupe County, TX",75992,73263,2729
48,189,"Hale County, TX",12596,11887,709
48,191,"Hall County, TX",1166,1088,78
48,193,"Hamilton County, TX",3602,3425,177
48,195,"Hansford County, TX",2946,2854,92
48,197,"Hardeman County, TX",1625,1561,64
48,199,"Hardin County, TX",25170,23636,1534
48,201,"Harris County, TX",2251316,2131125,120191
48,203,"Harrison County, TX",29961,28159,1802
48,205,"Hartley County, TX",2961,2901,60
48,207,"Haskell County, TX",2509,2403,106
48,209,"Hays County, TX",104921,101416,3505
48,211,"Hemphill County, TX",2115,2036,79
48,213,"Henderson County, TX",35398,33741,1657
48,215,"Hidalgo County, TX",337251,310858,26393
48,217,"Hill County, TX",15812,15114,698
48,219,"Hockley County, TX",11176,10656,520
48,221,"Hood County, TX",25276,24086,1190
48,223,"Hopkins County, TX",17331,16639,692
48,225,"Houston County, TX",10067,9602,465
48,227,"Howard County, TX",13218,12486,732
48,229,"Hudspeth County, TX",1542,1450,92
48,231,"Hunt County, TX",40532,38793,1739
48,233,"Hutchinson County, TX",9639,9095,544
48,235,"Irion County, TX",780,755,25
48,237,"Jack County, TX",3857,3666,191
48,239,"Jackson County, TX",7277,6936,341
48,241,"Jasper County, TX",13472,12437,1035
48,243,"Jeff Davis County, TX",1074,1042,32
48,245,"Jefferson County, TX",107546,99999,7547
48,247,"Jim Hogg County, TX",1945,1759,186
48,249,"Jim Wells County, TX",17470,15625,1845
48,251,"Johnson County, TX",76072,72753,3319
48,253,"Jones County, TX",5627,5300,327
48,255,"Karnes County, TX",6279,5972,307
48,257,"Kaufman County, TX",57940,55742,2198
48,259,"Kendall County, TX",20353,19702,651
48,261,"Kenedy County, TX",217,207,10
48,263,"Kent County, TX",470,456,14
48,265,"Kerr County, TX",21366,20597,769
48,267,"Kimble County, TX",1953,1879,74
48,269,"King County, TX",178,171,7
48,271,"Kinney County, TX",1156,1089,67
48,273,"Kleberg County, TX",14114,13165,949
48,275,"Knox County, TX",1560,1494,66
48,277,"Lamar County, TX",23238,22161,1077
48,279,"Lamb County, TX",5249,4908,341
48,281,"Lampasas County, TX",9164,8783,381
48,283,"La Salle County, TX",3887,3687,200
48,285,"Lavaca County, TX",8746,8376,370
48,287,"Lee County, TX",9286,8936,350
48,289,"Leon County, TX",6513,6091,422
48,291,"Liberty County, TX",31554,29176,2378
48,293,"Limestone County, TX",8329,7862,467
48,295,"Lipscomb County, TX",1652,1579,73
48,297,"Live Oak County, TX",5206,4897,309
48,299,"Llano County, TX",8296,7950,346
48,301,"Loving County, TX",86,82,4
48,303,"Lubbock County, TX",153626,148411,5215
48,305,"Lynn County, TX",2731,2622,109
48,307,"McCulloch County, TX",3712,3545,167
48,309,"McLennan County, TX",116150,111548,4602
48,311,"McMullen County, TX",862,844,18
48,313,"Madison County, TX",4770,4527,243
48,315,"Marion County, TX",4343,4038,305
48,317,"Martin County, TX",2483,2374,109
48,319,"Mason County, TX",1791,1726,65
48,321,"Matagorda County, TX",16890,15653,1237
48,323,"Maverick County, TX",24249,21519,2730
48,325,"Medina County, TX",20999,20073,926
48,327,"Menard County, TX",818,781,37
48,329,"Midland County, TX",85080,81326,3754
48,331,"Milam County, TX",10272,9742,530
48,333,"Mills County, TX",1925,1845,80
48,335,"Mitchell County, TX",2610,2427,183
48,337,"Montague County, TX",9035,8587,448
48,339,"Montgomery County, TX",265996,252941,13055
48,341,"Moore County, TX",11197,10864,333
48,343,"Morris County, TX",4895,4359,536
48,345,"Motley County, TX",508,490,18
48,347,"Nacogdoches County, TX",28722,27375,1347
48,349,"Navarro County, TX",22775,21822,953
48,351,"Newton County, TX",5355,4930,425
48,353,"Nolan County, TX",6867,6537,330
48,355,"Nueces County, TX",167827,158355,9472
48,357,"Ochiltree County, TX",4664,4419,245
48,359,"Oldham County, TX",908,881,27
48,361,"Orange County, TX",37368,34859,2509
48,363,"Palo Pinto County, TX",13256,12530,726
48,365,"Panola County, TX",10235,9500,735
48,367,"Parker County, TX",61297,58798,2499
48,369,"Parmer County, TX",4950,4825,125
48,371,"Pecos County, TX",6498,6116,382
48,373,"Polk County, TX",17388,16287,1101
48,375,"Potter County, TX",56177,54294,1883
48,377,"Presidio County, TX",3081,2751,330
48,379,"Rains County, TX",5556,5333,223
48,381,"Randall County, TX",70685,68595,2090
48,383,"Reagan County, TX",1702,1597,105
48,385,"Real County, TX",1041,982,59
48,387,"Red River County, TX",5036,4744,292
48,389,"Reeves County, TX",6036,5715,321
48,391,"Refugio County, TX",3137,2929,208
48,393,"Roberts County, TX",442,422,20
48,395,"Robertson County, TX",7258,6890,368
48,397,"Rockwall County, TX",47367,45704,1663
48,399,"Runnels County, TX",4649,4465,184
48,401,"Rusk County, TX",22382,21076,1306
48,403,"Sabine County, TX",3484,3157,327
48,405,"San Augustine County, TX",2805,2554,251
48,407,"San Jacinto County, TX",11431,10713,718
48,409,"San Patricio County, TX",30623,28335,2288
48,411,"San Saba County, TX",2448,2365,83
48,413,"Schleicher County, TX",1421,1347,74
48,415,"Scurry County, TX",7410,6973,437
48,417,"Shackelford County, TX",1878,1806,72
48,419,"Shelby County, TX",10959,10300,659
48,421,"Sherman County, TX",1351,1311,40
48,423,"Smith County, TX",105484,100706,4778
48,425,"Somervell County, TX",4134,3935,199
48,427,"Starr County, TX",26365,22837,3528
48,429,"Stephens County, TX",4019,3807,212
48,431,"Sterling County, TX",670,644,26
48,433,"Stonewall County, TX",640,612,28
48,435,"Sutton County, TX",1592,1465,127
48,437,"Swisher County, TX",2716,2600,116
48,439,"Tarrant County, TX",1011543,971204,40339
48,441,"Taylor County, TX",63322,60949,2373
48,443,"Terrell County, TX",407,390,17
48,445,"Terry County, TX",5352,5096,256
48,447,"Throckmorton County, TX",743,717,26
48,449,"Titus County, TX",12884,12088,796
48,451,"Tom Green County, TX",54272,51838,2434
48,453,"Travis County, TX",678480,656873,21607
48,455,"Trinity County, TX",5485,5151,334
48,457,"Tyler County, TX",7217,6689,528
48,459,"Upshur County, TX",17903,16754,1149
48,461,"Upton County, TX",1582,1498,84
48,463,"Uvalde County, TX",11813,11184,629
48,465,"Val Verde County, TX",20147,18887,1260
48,467,"Van Zandt County, TX",24862,23791,1071
48,469,"Victoria County, TX",43732,41357,2375
48,471,"Walker County, TX",23797,22547,1250
48,473,"Waller County, TX",22180,20939,1241
48,475,"Ward County, TX",5397,5089,308
48,477,"Washington County, TX",15089,14320,769
48,479,"Webb County, TX",113897,108314,5583
48,481,"Wharton County, TX",21080,20018,1062
48,483,"Wheeler County, TX",2484,2366,118
48,485,"Wichita County, TX",55486,53072,2414
48,487,"Wilbarger County, TX",5050,4812,238
48,489,"Willacy County, TX",6505,5707,798
48,491,"Williamson County, TX",278717,269349,9368
48,493,"Wilson County, TX",23760,22830,930
48,495,"Winkler County, TX",3071,2834,237
48,497,"Wise County, TX",29438,28044,1394
48,499,"Wood County, TX",17248,16339,909
48,501,"Yoakum County, TX",3762,3582,180
48,503,"Young County, TX",8312,7947,365
48,505,"Zapata County, TX",5210,4648,562
48,507,"Zavala County, TX",3887,3347,540
49,001,"Beaver County, UT",3065,2918,147
49,003,"Box Elder County, UT",24595,23763,832
49,005,"Cache County, UT",61026,59218,1808
49,007,"Carbon County, UT",8298,7819,479
49,009,"Daggett County, UT",461,438,23
49,011,"Davis County, UT",163777,158759,5018
49,013,"Duchesne County, UT",8070,7373,697
49,015,"Emery County, UT",4246,3988,258
49,017,"Garfield County, UT",2779,2554,225
49,019,"Grand County, UT",5701,5376,325
49,021,"Iron County, UT",21385,20480,905
49,023,"Juab County, UT",5200,5016,184
49,025,"Kane County, UT",3679,3543,136
49,027,"Millard County, UT",6190,5990,200
49,029,"Morgan County, UT",5125,4977,148
49,031,"Piute County, UT",456,430,26
49,033,"Rich County, UT",1091,1057,34
49,035,"Salt Lake County, UT",599503,581020,18483
49,037,"San Juan County, UT",5713,5265,448
49,039,"Sanpete County, UT",11755,11300,455
49,041,"Sevier County, UT",9551,9145,406
49,043,"Summit County, UT",23791,23066,725
49,045,"Tooele County, UT",30713,29582,1131
49,047,"Uintah County, UT",14057,12782,1275
49,049,"Utah County, UT",277959,269619,8340
49,051,"Wasatch County, UT",13853,13398,455
49,053,"Washington County, UT",67007,64578,2429
49,055,"Wayne County, UT",1419,1312,107
49,057,"Weber County, UT",119671,115214,4457
50,001,"Addison County, VT",20925,20323,602
50,003,"Bennington County, VT",18503,17830,673
50,005,"Caledonia County, VT",14946,14345,601
50,007,"Chittenden County, VT",95560,93248,2312
50,009,"Essex County, VT",2708,2577,131
50,011,"Franklin County, VT",27448,26623,825
50,013,"Grand Isle County, VT",3988,3844,144
50,015,"Lamoille County, VT",13961,13389,572
50,017,"Orange County, VT",15951,15472,479
50,019,"Orleans County, VT",13572,12883,689
50,021,"Rutland County, VT",31554,30405,1149
50,023,"Washington County, VT",34014,32965,1049
50,025,"Windham County, VT",23294,22545,749
50,027,"Windsor County, VT",29429,28594,835
51,001,"Accomack County, VA",15820,15060,760
51,003,"Albemarle County, VA",54534,52631,1903
51,005,"Alleghany County, VA",6941,6593,348
51,007,"Amelia County, VA",6207,5947,260
51,009,"Amherst County, VA",15010,14364,646
51,011,"Appomattox County, VA",7006,6684,322
51,013,"Arlington County, VA",146628,142857,3771
51,015,"Augusta County, VA",36898,35570,1328
51,017,"Bath County, VA",2499,2408,91
51,019,"Bedford County, VA",38012,36486,1526
51,021,"Bland County, VA",2742,2601,141
51,023,"Botetourt County, VA",17375,16755,620
51,025,"Brunswick County, VA",6216,5852,364
51,027,"Buchanan County, VA",6860,6136,724
51,029,"Buckingham County, VA",6273,5939,334
51,031,"Campbell County, VA",25973,24840,1133
51,033,"Caroline County, VA",14875,14224,651
51,035,"Carroll County, VA",12977,12321,656
51,036,"Charles City County, VA",3724,3558,166
51,037,"Charlotte County, VA",5259,5000,259
51,041,"Chesterfield County, VA",180972,174105,6867
51,043,"Clarke County, VA",7446,7184,262
51,045,"Craig County, VA",2353,2243,110
51,047,"Culpeper County, VA",23481,22585,896
51,049,"Cumberland County, VA",4609,4400,209
51,051,"Dickenson County, VA",4575,4128,447
51,053,"Dinwiddie County, VA",13461,12815,646
51,057,"Essex County, VA",5529,5267,262
51,059,"Fairfax County, VA",617693,598093,19600
51,061,"Fauquier County, VA",35977,34745,1232
51,063,"Floyd County, VA",8201,7873,328
51,065,"Fluvanna County, VA",13201,12764,437
51,067,"Franklin County, VA",26402,25288,1114
51,069,"Frederick County, VA",45404,43842,1562
51,071,"Giles County, VA",7950,7530,420
51,073,"Gloucester County, VA",19118,18430,688
51,075,"Goochland County, VA",10845,10443,402
51,077,"Grayson County, VA",7031,6677,354
51,079,"Greene County, VA",9946,9626,320
51,081,"Greensville County, VA",4212,4002,210
51,083,"Halifax County, VA",14880,14026,854
51,085,"Hanover County, VA",57255,55280,1975
51,087,"Henrico County, VA",179085,172221,6864
51,089,"Henry County, VA",22165,20946,1219
51,091,"Highland County, VA",1308,1268,40
51,093,"Isle of Wight County, VA",18955,18151,804
51,095,"James City County, VA",34910,33580,1330
51,097,"King and Queen County, VA",3665,3515,150
51,099,"King George County, VA",12336,11817,519
51,101,"King William County, VA",8762,8435,327
51,103,"Lancaster County, VA",5115,4832,283
51,105,"Lee County, VA",8451,7886,565
51,107,"Loudoun County, VA",207602,201078,6524
51,109,"Louisa County, VA",18595,17895,700
51,111,"Lunenburg County, VA",5260,5021,239
51,113,"Madison County, VA",7183,6962,221
51,115,"Mathews County, VA",4045,3885,160
51,117,"Mecklenburg County, VA",12473,11783,690
51,119,"Middlesex County, VA",5035,4845,190
51,121,"Montgomery County, VA",49796,47769,2027
51,125,"Nelson County, VA",7246,6989,257
51,127,"New Kent County, VA",11690,11300,390
51,131,"Northampton County, VA",5881,5546,335
51,133,"Northumberland County, VA",5454,5161,293
51,135,"Nottoway County, VA",7044,6768,276
51,137,"Orange County, VA",16386,15730,656
51,139,"Page County, VA",11606,10971,635
51,141,"Patrick County, VA",7962,7582,380
51,143,"Pittsylvania County, VA",29732,28343,1389
51,145,"Powhatan County, VA",13656,13180,476
51,147,"Prince Edward County, VA",10166,9632,534
51,149,"Prince George County, VA",14949,14234,715
51,153,"Prince William County, VA",235285,226848,8437
51,155,"Pulaski County, VA",16285,15331,954
51,157,"Rappahannock County, VA",3717,3588,129
51,159,"Richmond County, VA",3913,3771,142
51,161,"Roanoke County, VA",49206,47475,1731
51,163,"Rockbridge County, VA",10475,10024,451
51,165,"Rockingham County, VA",40616,39212,1404
51,167,"Russell County, VA",11253,10538,715
51,169,"Scott County, VA",9436,8982,454
51,171,"Shenandoah County, VA",20856,20084,772
51,173,"Smyth County, VA",13691,12909,782
51,175,"Southampton County, VA",9049,8699,350
51,177,"Spotsylvania County, VA",65027,62413,2614
51,179,"Stafford County, VA",68383,65749,2634
51,181,"Surry County, VA",3660,3471,189
51,183,"Sussex County, VA",3952,3708,244
51,185,"Tazewell County, VA",15965,14787,1178
51,187,"Warren County, VA",19725,18940,785
51,191,"Washington County, VA",26881,25687,1194
51,193,"Westmoreland County, VA",8989,8584,405
51,195,"Wise County, VA",13211,12109,1102
51,197,"Wythe County, VA",13673,12905,768
51,199,"York County, VA",32155,30926,1229
51,510,"Alexandria city, VA",96536,93776,2760
51,520,"Bristol city, VA",7455,7084,371
51,530,"Buena Vista city, VA",3279,3115,164
51,540,"Charlottesville city, VA",24916,24088,828
51,550,"Chesapeake city, VA",118086,113123,4963
51,570,"Colonial Heights city, VA",8723,8338,385
51,580,"Covington city, VA",2385,2247,138
51,590,"Danville city, VA",19125,17984,1141
51,595,"Emporia city, VA",2246,2104,142
51,600,"Fairfax city, VA",12993,12602,391
51,610,"Falls Church city, VA",7993,7778,215
51,620,"Franklin city, VA",3540,3329,211
51,630,"Fredericksburg city, VA",13575,12936,639
51,640,"Galax city, VA",2905,2764,141
51,650,"Hampton city, VA",64029,60438,3591
51,660,"Harrisonburg city, VA",24259,23107,1152
51,670,"Hopewell city, VA",9786,9157,629
51,678,"Lexington city, VA",2267,2130,137
51,680,"Lynchburg city, VA",35557,33738,1819
51,683,"Manassas city, VA",21626,20858,768
51,685,"Manassas Park city, VA",8493,8188,305
51,690,"Martinsville city, VA",5167,4807,360
51,700,"Newport News city, VA",88936,84452,4484
51,710,"Norfolk city, VA",110464,104722,5742
51,720,"Norton city, VA",1662,1550,112
51,730,"Petersburg city, VA",13214,12194,1020
51,735,"Poquoson city, VA",6176,5963,213
51,740,"Portsmouth city, VA",44103,41436,2667
51,750,"Radford city, VA",8267,7826,441
51,760,"Richmond city, VA",114798,109549,5249
51,770,"Roanoke city, VA",48997,46924,2073
51,775,"Salem city, VA",12909,12409,500
51,790,"Staunton city, VA",11808,11354,454
51,800,"Suffolk city, VA",43013,41030,1983
51,810,"Virginia Beach city, VA",229517,220574,8943
51,820,"Waynesboro city, VA",10205,9788,417
51,830,"Williamsburg city, VA",6720,6354,366
51,840,"Winchester city, VA",14345,13780,565
53,001,"Adams County, WA",8717,8166,551
53,003,"Asotin County, WA",9972,9483,489
53,005,"Benton County, WA",94362,88504,5858
53,007,"Chelan County, WA",43313,40878,2435
53,009,"Clallam County, WA",27332,25285,2047
53,011,"Clark County, WA",220996,207736,13260
53,013,"Columbia County, WA",1720,1610,110
53,015,"Cowlitz County, WA",44876,41712,3164
53,017,"Douglas County, WA",20545,19154,1391
53,019,"Ferry County, WA",2493,2240,253
53,021,"Franklin County, WA",39864,36952,2912
53,023,"Garfield County, WA",920,867,53
53,025,"Grant County, WA",44585,41462,3123
53,027,"Grays Harbor County, WA",27256,25019,2237
53,029,"Island County, WA",32764,30860,1904
53,031,"Jefferson County, WA",11516,10714,802
53,033,"King County, WA",1213173,1166951,46222
53,035,"Kitsap County, WA",118285,111789,6496
53,037,"Kittitas County, WA",21549,20286,1263
53,039,"Klickitat County, WA",9649,9002,647
53,041,"Lewis County, WA",31938,29483,2455
53,043,"Lincoln County, WA",4894,4626,268
53,045,"Mason County, WA",23519,21769,1750
53,047,"Okanogan County, WA",21415,20015,1400
53,049,"Pacific County, WA",8295,7637,658
53,051,"Pend Oreille County, WA",4663,4254,409
53,053,"Pierce County, WA",404970,380954,24016
53,055,"San Juan County, WA",7879,7518,361
53,057,"Skagit County, WA",58012,54287,3725
53,059,"Skamania County, WA",5078,4731,347
53,061,"Snohomish County, WA",415292,397875,17417
53,063,"Spokane County, WA",234673,220625,14048
53,065,"Stevens County, WA",17894,16446,1448
53,067,"Thurston County, WA",129896,122677,7219
53,069,"Wahkiakum County, WA",1289,1179,110
53,071,"Walla Walla County, WA",28734,27206,1528
53,073,"Whatcom County, WA",107213,101059,6154
53,075,"Whitman County, WA",23132,21989,1143
53,077,"Yakima County, WA",125890,116529,9361
54,001,"Barbour County, WV",6983,6508,475
54,003,"Berkeley County, WV",54260,52110,2150
54,005,"Boone County, WV",8014,7284,730
54,007,"Braxton County, WV",5509,5026,483
54,009,"Brooke County, WV",10012,9306,706
54,011,"Cabell County, WV",41349,39356,1993
54,013,"Calhoun County, WV",2630,2292,338
54,015,"Clay County, WV",3269,2930,339
54,017,"Doddridge County, WV",3794,3597,197
54,019,"Fayette County, WV",16024,14752,1272
54,021,"Gilmer County, WV",2547,2337,210
54,023,"Grant County, WV",5974,5619,355
54,025,"Greenbrier County, WV",15735,14885,850
54,027,"Hampshire County, WV",9927,9495,432
54,029,"Hancock County, WV",12899,11995,904
54,031,"Hardy County, WV",5736,5409,327
54,033,"Harrison County, WV",32448,30555,1893
54,035,"Jackson County, WV",12045,11263,782
54,037,"Jefferson County, WV",28648,27683,965
54,039,"Kanawha County, WV",85575,80899,4676
54,041,"Lewis County, WV",6850,6268,582
54,043,"Lincoln County, WV",7312,6688,624
54,045,"Logan County, WV",11195,10052,1143
54,047,"McDowell County, WV",5102,4481,621
54,049,"Marion County, WV",25754,24069,1685
54,051,"Marshall County, WV",14111,12986,1125
54,053,"Mason County, WV",10063,9345,718
54,055,"Mercer County, WV",21760,20302,1458
54,057,"Mineral County, WV",11947,11235,712
54,059,"Mingo County, WV",6751,5899,852
54,061,"Monongalia County, WV",51452,49222,2230
54,063,"Monroe County, WV",5998,5725,273
54,065,"Morgan County, WV",7679,7342,337
54,067,"Nicholas County, WV",9619,8770,849
54,069,"Ohio County, WV",20695,19546,1149
54,071,"Pendleton County, WV",3665,3523,142
54,073,"Pleasants County, WV",2964,2721,243
54,075,"Pocahontas County, WV",3739,3490,249
54,077,"Preston County, WV",14900,14044,856
54,079,"Putnam County, WV",25859,24594,1265
54,081,"Raleigh County, WV",30031,27931,2100
54,083,"Randolph County, WV",12245,11511,734
54,085,"Ritchie County, WV",4578,4279,299
54,087,"Roane County, WV",5219,4681,538
54,089,"Summers County, WV",4585,4304,281
54,091,"Taylor County, WV",7844,7401,443
54,093,"Tucker County, WV",3487,3299,188
54,095,"Tyler County, WV",3559,3242,317
54,097,"Upshur County, WV",9837,9095,742
54,099,"Wayne County, WV",15582,14552,1030
54,101,"Webster County, WV",3502,3209,293
54,103,"Wetzel County, WV",7225,6557,668
54,105,"Wirt County, WV",2239,2042,197
54,107,"Wood County, WV",36940,34816,2124
54,109,"Wyoming County, WV",7444,6685,759
55,001,"Adams County, WI",8255,7770,485
55,003,"Ashland County, WI",7929,7510,419
55,005,"Barron County, WI",24277,23203,1074
55,007,"Bayfield County, WI",7507,7003,504
55,009,"Brown County, WI",140794,135820,4974
55,011,"Buffalo County, WI",6553,6268,285
55,013,"Burnett County, WI",7152,6735,417
55,015,"Calumet County, WI",27650,26782,868
55,017,"Chippewa County, WI",33263,31887,1376
55,019,"Clark County, WI",17481,16817,664
55,021,"Columbia County, WI",31490,30384,1106
55,023,"Crawford County, WI",7899,7523,376
55,025,"Dane County, WI",316992,308144,8848
55,027,"Dodge County, WI",47741,46043,1698
55,029,"Door County, WI",15457,14712,745
55,031,"Douglas County, WI",23499,22295,1204
55,033,"Dunn County, WI",24257,23290,967
55,035,"Eau Claire County, WI",58728,56769,1959
55,037,"Florence County, WI",2221,2093,128
55,039,"Fond du Lac County, WI",56786,54835,1951
55,041,"Forest County, WI",3987,3745,242
55,043,"Grant County, WI",28126,27054,1072
55,045,"Green County, WI",21153,20466,687
55,047,"Green Lake County, WI",9733,9270,463
55,049,"Iowa County, WI",13661,13195,466
55,051,"Iron County, WI",2629,2438,191
55,053,"Jackson County, WI",10298,9859,439
55,055,"Jefferson County, WI",45585,43852,1733
55,057,"Juneau County, WI",13498,12916,582
55,059,"Kenosha County, WI",88081,84061,4020
55,061,"Kewaunee County, WI",11005,10611,394
55,063,"La Crosse County, WI",67388,65012,2376
55,065,"Lafayette County, WI",9818,9514,304
55,067,"Langlade County, WI",9548,9064,484
55,069,"Lincoln County, WI",15218,14570,648
55,071,"Manitowoc County, WI",41731,39977,1754
55,073,"Marathon County, WI",73437,70883,2554
55,075,"Marinette County, WI",20173,19094,1079
55,077,"Marquette County, WI",7532,7159,373
55,078,"Menominee County, WI",1569,1452,117
55,079,"Milwaukee County, WI",475320,452193,23127
55,081,"Monroe County, WI",22965,22110,855
55,083,"Oconto County, WI",20406,19527,879
55,085,"Oneida County, WI",18531,17654,877
55,087,"Outagamie County, WI",103617,100040,3577
55,089,"Ozaukee County, WI",48924,47327,1597
55,091,"Pepin County, WI",4155,4001,154
55,093,"Pierce County, WI",24617,23645,972
55,095,"Polk County, WI",24806,23701,1105
55,097,"Portage County, WI",39386,37920,1466
55,099,"Price County, WI",6864,6576,288
55,101,"Racine County, WI",99453,94662,4791
55,103,"Richland County, WI",9240,8901,339
55,105,"Rock County, WI",83884,80279,3605
55,107,"Rusk County, WI",6983,6634,349
55,109,"St. Croix County, WI",49537,47714,1823
55,111,"Sauk County, WI",35144,33921,1223
55,113,"Sawyer County, WI",7893,7413,480
55,115,"Shawano County, WI",21235,20375,860
55,117,"Sheboygan County, WI",61579,59535,2044
55,119,"Taylor County, WI",11048,10605,443
55,121,"Trempealeau County, WI",16622,16024,598
55,123,"Vernon County, WI",15716,15158,558
55,125,"Vilas County, WI",9943,9394,549
55,127,"Walworth County, WI",57550,55307,2243
55,129,"Washburn County, WI",7952,7566,386
55,131,"Washington County, WI",77012,74493,2519
55,133,"Waukesha County, WI",224280,216710,7570
55,135,"Waupaca County, WI",26902,25864,1038
55,137,"Waushara County, WI",11447,10886,561
55,139,"Winnebago County, WI",92838,89604,3234
55,141,"Wood County, WI",34518,32929,1589
56,001,"Albany County, WY",20975,20299,676
56,003,"Big Horn County, WY",5540,5263,277
56,005,"Campbell County, WY",24415,22648,1767
56,007,"Carbon County, WY",8363,7969,394
56,009,"Converse County, WY",7879,7385,494
56,011,"Crook County, WY",3740,3567,173
56,013,"Fremont County, WY",20040,18591,1449
56,015,"Goshen County, WY",7029,6784,245
56,017,"Hot Springs County, WY",2425,2308,117
56,019,"Johnson County, WY",4207,3981,226
56,021,"Laramie County, WY",48803,46765,2038
56,023,"Lincoln County, WY",8725,8313,412
56,025,"Natrona County, WY",41016,38073,2943
56,027,"Niobrara County, WY",1338,1294,44
56,029,"Park County, WY",15931,15174,757
56,031,"Platte County, WY",4775,4544,231
56,033,"Sheridan County, WY",16127,15363,764
56,035,"Sublette County, WY",4232,3958,274
56,037,"Sweetwater County, WY",22140,20794,1346
56,039,"Teton County, WY",15247,14715,532
56,041,"Uinta County, WY",9426,8876,550
56,043,"Washakie County, WY",4214,4013,201
56,045,"Weston County, WY",3960,3761,199
72,001,"Adjuntas Municipio, PR",4470,3717,753
72,003,"Aguada Municipio, PR",11907,10245,1662
72,005,"Aguadilla Municipio, PR",14906,12689,2217
72,007,"Aguas Buenas Municipio, PR",6787,5814,973
72,009,"Aibonito Municipio, PR",6673,5680,993
72,011,"Anasco Municipio, PR",8893,7749,1144
72,013,"Arecibo Municipio, PR",23997,20832,3165
72,015,"Arroyo Municipio, PR",5140,4187,953
72,017,"Barceloneta Municipio, PR",5863,5034,829
72,019,"Barranquitas Municipio, PR",7480,6521,959
72,021,"Bayamon Municipio, PR",66356,60399,5957
72,023,"Cabo Rojo Municipio, PR",14168,12405,1763
72,025,"Caguas Municipio, PR",48264,43281,4983
72,027,"Camuy Municipio, PR",9505,8330,1175
72,029,"Canovanas Municipio, PR",16274,14404,1870
72,031,"Carolina Municipio, PR",62164,56791,5373
72,033,"Catano Municipio, PR",7912,7119,793
72,035,"Cayey Municipio, PR",16220,14480,1740
72,037,"Ceiba Municipio, PR",3798,3301,497
72,039,"Ciales Municipio, PR",3839,3220,619
72,041,"Cidra Municipio, PR",15580,13986,1594
72,043,"Coamo Municipio, PR",10868,8903,1965
72,045,"Comerio Municipio, PR",5072,4389,683
72,047,"Corozal Municipio, PR",9250,8114,1136
72,049,"Culebra Municipio, PR",896,866,30
72,051,"Dorado Municipio, PR",12924,11882,1042
72,053,"Fajardo Municipio, PR",11285,9728,1557
72,054,"Florida Municipio, PR",3370,2882,488
72,055,"Guanica Municipio, PR",4142,3394,748
72,057,"Guayama Municipio, PR",12052,10076,1976
72,059,"Guayanilla Municipio, PR",5292,4302,990
72,061,"Guaynabo Municipio, PR",37190,34975,2215
72,063,"Gurabo Municipio, PR",17513,16026,1487
72,065,"Hatillo Municipio, PR",13323,11253,2070
72,067,"Hormigueros Municipio, PR",5621,4933,688
72,069,"Humacao Municipio, PR",17467,15004,2463
72,071,"Isabela Municipio, PR",12613,10835,1778
72,073,"Jayuya Municipio, PR",4221,3675,546
72,075,"Juana Diaz Municipio, PR",15597,13338,2259
72,077,"Juncos Municipio, PR",12462,10817,1645
72,079,"Lajas Municipio, PR",5631,4580,1051
72,081,"Lares Municipio, PR",7412,5980,1432
72,083,"Las Marias Municipio, PR",2865,2439,426
72,085,"Las Piedras Municipio, PR",11365,9835,1530
72,087,"Loiza Municipio, PR",8654,7675,979
72,089,"Luquillo Municipio, PR",6333,5434,899
72,091,"Manati Municipio, PR",11648,10295,1353
72,093,"Maricao Municipio, PR",1955,1657,298
72,095,"Maunabo Municipio, PR",3020,2466,554
72,097,"Mayaguez Municipio, PR",23225,20039,3186
72,099,"Moca Municipio, PR",10745,9073,1672
72,101,"Morovis Municipio, PR",8119,7027,1092
72,103,"Naguabo Municipio, PR",8086,7089,997
72,105,"Naranjito Municipio, PR",7260,6319,941
72,107,"Orocovis Municipio, PR",5204,4397,807
72,109,"Patillas Municipio, PR",4813,3820,993
72,111,"Penuelas Municipio, PR",6120,5099,1021
72,113,"Ponce Municipio, PR",47812,41397,6415
72,115,"Quebradillas Municipio, PR",6079,5109,970
72,117,"Rincon Municipio, PR",4631,3908,723
72,119,"Rio Grande Municipio, PR",17095,15303,1792
72,121,"Sabana Grande Municipio, PR",6446,5424,1022
72,123,"Salinas Municipio, PR",7568,5928,1640
72,125,"San German Municipio, PR",10356,8775,1581
72,127,"San Juan Municipio, PR",135159,124495,10664
72,129,"San Lorenzo Municipio, PR",11910,10418,1492
72,131,"San Sebastian Municipio, PR",10721,8694,2027
72,133,"Santa Isabel Municipio, PR",9898,8244,1654
72,135,"Toa Alta Municipio, PR",26551,24343,2208
72,137,"Toa Baja Municipio, PR",29753,27071,2682
72,139,"Trujillo Alto Municipio, PR",27127,25174,1953
72,141,"Utuado Municipio, PR",6885,5817,1068
72,143,"Vega Alta Municipio, PR",9878,8740,1138
72,145,"Vega Baja Municipio, PR",13733,11829,1904
72,147,"Vieques Municipio, PR",3260,2914,346
72,149,"Villalba Municipio, PR",7815,6235,1580
72,151,"Yabucoa Municipio, PR",9081,7545,1536
72,153,"Yauco Municipio, PR",10735,8719,2016
